turns,winner,white_rating,black_rating,opening_moves,rating_gap,higher_rated_victory
13,2,1500,1191,5,309,1
16,1,1322,1261,4,61,0
61,2,1496,1500,3,4,0
61,2,1439,1454,3,15,0
95,2,1523,1469,5,54,1
5,0,1250,1002,4,248,0
33,2,1520,1423,10,97,1
9,1,1413,2108,5,695,1
66,1,1439,1392,6,47,0
119,2,1381,1209,4,172,1
39,2,1381,1272,1,109,1
38,1,1381,1867,9,486,1
60,1,1381,1936,3,555,1
31,1,1381,1607,2,226,1
31,2,1094,1141,8,47,0
43,1,1141,1094,7,47,0
52,1,1094,1141,8,47,1
66,1,1141,1094,8,47,0
101,1,1094,1300,5,206,1
25,2,1500,1094,2,406,1
14,1,1094,1676,6,582,1
3,2,1094,1068,2,26,1
17,2,1500,1094,3,406,1
36,2,1307,1106,4,201,1
13,1,1113,1423,3,310,1
69,2,1078,1219,4,141,0
43,2,1825,1079,8,746,1
54,1,1328,1038,4,290,0
53,1,1056,1156,4,100,1
66,1,1077,1148,4,71,1
64,1,1358,1036,3,322,0
64,1,1200,1002,6,198,0
54,2,1203,1019,3,184,1
21,1,1019,1500,6,481,1
11,2,1422,975,3,447,1
19,1,976,1832,4,856,1
28,2,1569,978,10,591,1
22,1,978,1500,2,522,1
37,2,1500,978,17,522,1
34,2,2449,978,3,1471,1
32,0,1207,978,10,229,0
71,1,1241,978,3,263,0
30,2,1500,978,3,522,1
66,2,2443,978,17,1465,1
41,2,1500,978,3,522,1
49,2,1500,978,3,522,1
3,1,978,1500,2,522,1
7,2,1343,978,3,365,1
35,2,2436,978,17,1458,1
41,2,2436,978,4,1458,1
5,1,978,1500,3,522,1
7,2,1500,978,4,522,1
53,2,978,1500,2,522,0
36,1,1500,978,2,522,0
8,2,1521,1162,2,359,1
3,2,1407,1500,3,93,0
28,2,1492,1458,5,34,1
30,1,1414,1442,8,28,1
44,1,1457,1294,5,163,0
29,2,1525,1466,6,59,1
37,1,1207,1579,3,372,1
49,2,1567,1573,2,6,0
32,1,1578,1605,2,27,1
25,2,1939,1581,6,358,1
40,1,1618,1568,2,50,0
39,2,1755,1574,2,181,1
57,2,1561,1596,2,35,0
78,1,1500,1554,3,54,1
61,2,1544,1461,3,83,1
44,1,1563,1335,3,228,0
62,1,1579,1470,2,109,0
87,2,1617,1590,2,27,1
54,1,1207,1588,7,381,1
54,1,1595,1547,3,48,0
37,2,1855,1599,5,256,1
50,2,1589,1547,2,42,1
131,2,1571,1728,5,157,0
48,2,1720,1579,3,141,1
47,1,1579,2105,5,526,1
64,1,1768,1560,3,208,0
61,2,1552,1436,3,116,1
57,2,1536,1667,5,131,0
51,2,1521,1549,2,28,0
58,1,1251,1545,3,294,1
71,2,1537,1408,3,129,1
114,2,1522,1512,1,10,1
39,2,1602,1532,11,70,1
20,1,1543,1593,5,50,1
48,1,1556,1539,3,17,0
34,1,1409,1548,3,139,1
51,2,1539,1418,5,121,1
69,2,1603,1550,3,53,1
28,2,1542,1399,4,143,1
62,1,1546,1877,5,331,1
62,1,1134,1535,4,401,1
85,2,1513,1784,2,271,0
38,2,1501,1445,5,56,1
14,2,1500,1500,8,0,0
113,0,1745,1714,4,31,0
62,2,1734,1748,4,14,0
101,2,1942,1739,6,203,1
75,2,1724,1855,7,131,0
135,2,1951,1729,11,222,1
81,2,1726,1388,5,338,1
46,1,1735,1806,6,71,1
70,1,1597,1728,3,131,1
39,2,1743,1738,10,5,1
91,2,1721,1750,7,29,0
137,2,1746,1487,5,259,1
46,1,1744,1735,9,9,0
18,1,1749,1631,9,118,0
28,1,1769,1396,5,373,0
40,1,1795,1760,5,35,0
111,2,1729,1795,5,66,0
54,1,1795,1784,6,11,0
33,2,1770,1872,3,102,0
90,1,1783,1721,5,62,0
90,1,1884,1768,7,116,0
40,1,1756,1756,5,0,0
49,2,1724,1958,5,234,0
50,1,2036,1706,6,330,0
59,2,1706,925,5,781,1
26,1,1244,1219,4,25,0
23,2,1215,921,5,294,1
118,1,1350,1201,5,149,0
66,1,1210,1280,4,70,1
120,0,1139,1212,8,73,0
36,1,1220,1341,11,121,1
26,1,1234,1359,6,125,1
62,1,1275,1236,11,39,0
37,2,1433,1282,3,151,1
24,1,1132,1276,4,144,1
47,2,1276,1308,6,32,0
37,1,1228,1266,7,38,1
24,1,1273,1409,5,136,1
9,2,1338,1277,3,61,1
47,2,1263,1336,8,73,0
85,2,1316,1273,2,43,1
39,2,1248,1253,2,5,0
58,1,1335,1233,6,102,0
95,2,1223,1189,11,34,1
2,1,1443,1204,2,239,0
97,2,1227,1216,4,11,1
12,0,1215,1219,5,4,0
30,2,1227,1227,8,0,0
43,2,1550,1225,8,325,1
11,2,1325,1234,2,91,1
72,1,1212,1221,5,9,1
156,1,1226,1478,3,252,1
18,1,1228,1626,4,398,1
77,2,1191,1228,7,37,0
32,1,1422,1210,5,212,0
35,2,1186,1223,5,37,0
85,2,1212,1212,2,0,0
50,1,1228,1343,6,115,1
111,2,1865,1862,5,3,1
65,2,1852,1852,5,0,0
73,2,1833,1863,4,30,0
125,2,1851,1918,4,67,0
76,1,1861,1844,6,17,0
65,2,1853,1774,6,79,1
41,2,1910,1862,11,48,1
59,2,1851,1890,3,39,0
70,1,1860,1840,5,20,0
34,2,1828,1848,5,20,0
69,2,1855,1858,1,3,0
63,2,1847,1895,8,48,0
107,2,1885,1856,4,29,1
58,2,1847,1802,1,45,1
34,1,1847,1856,6,9,1
100,1,1840,1837,3,3,0
80,1,1848,1806,4,42,0
44,1,1860,1820,3,40,0
40,1,1854,1849,3,5,0
105,2,1895,1859,4,36,1
50,1,1866,1965,6,99,1
144,0,1866,1843,4,23,0
81,1,1835,1866,11,31,1
69,1,1877,1860,6,17,0
77,2,1849,1874,11,25,0
158,1,1835,1865,6,30,1
107,0,1866,1835,7,31,0
117,2,1856,1829,12,27,1
44,2,1845,1846,8,1,0
40,1,1834,1835,4,1,1
59,2,1846,1845,2,1,1
110,1,1845,1917,4,72,1
30,1,1858,1790,4,68,0
54,1,1871,1847,4,24,0
69,1,1846,1869,5,23,1
178,1,1843,1836,3,7,0
136,1,1800,1826,2,26,1
124,1,1283,1267,5,16,0
96,1,1290,1270,1,20,0
53,2,1331,1281,4,50,1
39,2,1304,1292,1,12,1
10,1,1305,1293,3,12,0
51,2,1308,1317,8,9,0
18,1,1296,1305,13,9,1
106,1,968,1305,8,337,1
38,1,1293,1466,5,173,1
59,2,1500,1299,7,201,1
111,2,1288,1232,3,56,1
28,1,1289,2108,9,819,1
101,2,1431,1289,6,142,1
15,2,1806,1289,7,517,1
42,2,1289,1311,5,22,0
118,1,1431,1289,3,142,0
34,1,1289,1484,6,195,1
60,1,1289,1810,5,521,1
66,1,1806,1289,5,517,0
21,2,1289,1500,5,211,0
73,2,1409,1297,8,112,1
159,2,1280,1485,6,205,0
74,2,1280,1211,4,69,1
28,1,1211,1280,3,69,1
112,1,1281,1765,6,484,1
104,1,1288,1454,4,166,1
40,1,1560,1270,5,290,0
44,1,1274,1534,4,260,1
150,0,1259,1663,6,404,0
60,1,1614,1238,5,376,0
37,2,1221,1417,11,196,0
88,1,1222,1732,7,510,1
113,2,1232,1234,7,2,0
55,2,1240,1219,8,21,1
135,2,1590,1600,5,10,0
137,0,1568,1617,5,49,0
97,2,1500,1358,6,142,1
33,1,1384,1325,2,59,0
29,1,1384,1265,3,119,0
55,1,1384,1950,2,566,1
91,2,1377,1249,4,128,1
53,2,1375,1389,4,14,0
49,2,1378,1361,5,17,1
48,1,1261,1371,4,110,1
20,1,1380,1429,4,49,1
87,2,1369,1368,6,1,1
11,2,1290,1371,9,81,0
110,0,1372,1326,2,46,0
24,2,1361,1383,1,22,0
23,2,1217,1399,4,182,0
81,2,1387,1447,5,60,0
34,1,1474,1387,2,87,0
103,2,1377,1351,4,26,1
29,1,1389,1339,4,50,0
22,1,1389,1400,4,11,1
38,2,1849,1389,5,460,1
46,1,1395,1378,9,17,0
23,2,1370,1257,6,113,1
31,2,1360,1332,5,28,1
51,2,1311,1360,4,49,0
87,2,1714,1360,6,354,1
31,2,1354,1217,5,137,1
38,1,1245,1346,5,101,1
43,2,1346,1099,6,247,1
105,2,1336,1287,4,49,1
87,2,1580,1555,2,25,1
36,1,1555,1580,6,25,1
38,1,1649,1547,6,102,0
110,1,1426,1527,3,101,1
48,1,1557,1547,8,10,0
95,2,1557,1607,5,50,0
70,1,1607,1557,1,50,0
42,2,1557,1632,7,75,0
177,2,1535,1609,11,74,0
114,1,1713,1558,2,155,0
57,2,1497,1730,2,233,0
57,2,1437,1552,5,115,0
82,0,1516,1552,2,36,0
29,2,1513,1456,5,57,1
70,1,1355,1478,7,123,1
97,2,1638,1614,6,24,1
99,2,1613,1934,11,321,0
74,1,1865,1613,5,252,0
48,1,1776,1587,2,189,0
77,2,1568,1593,6,25,0
80,1,1605,1546,6,59,0
35,2,1518,1709,5,191,0
33,2,1728,1527,8,201,1
87,2,1515,1379,4,136,1
40,1,1538,1501,4,37,0
54,1,1511,1516,4,5,1
67,1,1464,1495,9,31,1
21,2,1470,1475,4,5,0
14,1,1490,1440,6,50,0
71,2,1611,1974,18,363,0
72,1,1611,1945,8,334,1
62,1,1584,1611,5,27,1
48,1,1942,1611,1,331,0
6,1,1217,1611,6,394,1
69,0,1611,2059,12,448,0
72,2,1611,1478,4,133,1
40,1,1486,1552,5,66,1
29,2,1453,1496,2,43,0
44,2,1340,1326,2,14,1
59,2,1532,1500,3,32,1
115,2,1560,1557,6,3,1
70,1,1571,1577,2,6,1
36,1,1580,1617,2,37,1
83,2,1531,1593,7,62,0
99,0,1449,1597,9,148,0
43,2,1743,1604,6,139,1
89,2,1604,1614,8,10,0
96,1,1550,1605,3,55,1
116,1,1630,1605,8,25,0
78,1,1475,1605,1,130,1
77,2,1605,1475,1,130,1
70,1,1475,1605,3,130,1
27,2,1570,1605,7,35,0
102,1,1605,1500,1,105,0
21,2,1500,1605,9,105,0
33,2,1605,1500,1,105,1
74,1,1513,1605,5,92,1
65,2,1790,1874,1,84,0
81,2,1864,1805,5,59,1
45,1,1496,1861,3,365,1
52,2,1851,1853,8,2,0
51,2,1861,1863,4,2,0
48,0,1618,1609,3,9,0
20,1,1620,1607,1,13,0
50,1,1621,1496,5,125,0
98,1,1633,1581,5,52,0
106,1,1623,1623,6,0,0
19,2,1612,1614,5,2,0
22,2,1605,1624,8,19,0
114,0,1693,1621,4,72,0
69,1,1631,1684,4,53,1
34,1,1636,1619,8,17,0
40,1,1613,1617,8,4,1
108,1,1627,1495,6,132,0
27,2,1480,1643,3,163,0
63,2,1631,1652,5,21,0
31,2,1687,1641,5,46,1
71,2,1630,1638,6,8,0
92,1,1414,1624,6,210,1
47,2,1619,1419,7,200,1
56,1,1629,1659,5,30,1
48,2,1649,1639,3,10,1
124,1,1677,1627,1,50,0
49,2,1705,1636,8,69,1
64,1,1647,1635,13,12,0
29,2,1637,1627,7,10,1
45,2,1626,1631,5,5,0
96,1,1602,1615,6,13,1
92,1,1634,1603,3,31,0
40,1,1611,1591,9,20,0
123,2,1579,1623,19,44,0
129,2,1995,1581,4,414,1
120,1,1589,1569,9,20,0
71,0,1570,1555,6,15,0
97,2,1559,1557,3,2,1
60,2,1546,1571,2,25,0
57,2,1550,1567,6,17,0
38,2,1560,1419,5,141,1
111,2,1840,1564,8,276,1
119,1,1660,1549,4,111,0
33,2,1534,1678,5,144,0
32,2,1789,1538,6,251,1
96,1,1841,1921,8,80,1
92,0,1926,1737,2,189,0
64,1,1629,1887,3,258,1
10,1,1860,1712,7,148,0
85,2,1500,1568,4,68,0
40,1,1780,2132,10,352,1
58,1,966,1124,2,158,1
26,1,884,951,2,67,1
4,1,945,1070,3,125,1
118,1,971,1149,3,178,1
11,2,1238,985,1,253,1
163,0,972,1247,2,275,0
95,2,1107,961,4,146,1
37,1,974,1129,3,155,1
101,2,1203,970,3,233,1
80,1,998,937,5,61,0
78,1,1016,1126,1,110,1
89,0,1025,1153,4,128,0
42,1,1047,1151,4,104,1
8,1,998,1016,6,18,1
101,2,1127,1044,3,83,1
65,2,1020,1200,3,180,0
60,1,1069,1071,4,2,1
71,0,1071,1068,3,3,0
44,1,1115,1223,4,108,1
20,1,1190,1213,4,23,1
41,2,1337,1337,3,0,0
40,1,1500,1500,2,0,0
27,2,1500,1571,7,71,0
59,1,1367,1866,1,499,1
19,2,1590,1373,2,217,1
50,1,1377,1667,1,290,1
34,1,1558,1358,15,200,0
15,2,1476,1367,2,109,1
52,1,1376,1469,1,93,1
65,2,1460,1386,2,74,1
67,2,1372,1408,5,36,0
31,1,1373,2148,4,775,1
130,1,1500,1395,2,105,0
125,2,1382,1414,5,32,0
76,1,1320,1400,3,80,1
121,2,1383,1330,3,53,1
53,2,1383,1242,3,141,1
116,1,1469,1357,9,112,0
47,2,959,1357,4,398,0
53,2,1357,959,3,398,1
76,1,959,1357,4,398,1
110,0,1588,1691,8,103,0
67,2,1541,1586,9,45,0
17,2,1517,1320,4,197,1
39,2,1569,1569,2,0,0
94,1,1563,1498,5,65,0
37,2,1903,1512,8,391,1
37,2,1612,1450,5,162,1
34,2,1327,1450,3,123,0
41,2,1245,1450,5,205,0
30,1,1921,1451,4,470,0
51,2,1462,1464,3,2,0
79,2,1450,1486,6,36,0
83,2,1439,1418,5,21,1
14,1,1728,1500,6,228,0
21,2,1547,1563,4,16,0
47,2,1863,1567,2,296,1
38,2,1559,1423,2,136,1
34,1,1570,1611,7,41,1
39,2,1562,1582,6,20,0
43,2,1576,1386,3,190,1
41,2,1353,1595,3,242,0
49,2,1591,1326,3,265,1
38,1,1560,1580,4,20,1
70,1,1727,1574,4,153,0
48,1,1579,1841,4,262,1
50,1,1877,1558,11,319,0
57,2,1536,1962,3,426,0
148,0,1529,1763,3,234,0
62,1,1590,1515,4,75,0
29,2,1653,1522,2,131,1
52,1,1675,1505,6,170,0
26,1,1547,1491,6,56,0
59,1,1507,1399,2,108,0
2,0,1641,1502,2,139,0
195,0,1496,1703,5,207,0
56,1,1482,1484,4,2,1
40,1,1486,1909,2,423,1
31,2,1919,1488,2,431,1
60,1,1488,2192,2,704,1
45,2,1470,1684,3,214,0
63,0,1465,1659,3,194,0
17,2,1586,1473,5,113,1
34,2,1548,1488,6,60,1
36,1,1500,1501,2,1,1
62,1,1509,1487,8,22,0
46,0,1356,1491,2,135,0
34,1,1495,1771,2,276,1
38,2,1529,1639,3,110,0
107,2,1631,1537,6,94,1
42,1,1546,1621,6,75,1
35,2,1568,1636,5,68,0
122,1,1354,1631,5,277,1
71,2,1626,1384,7,242,1
42,1,1639,1813,6,174,1
2,1,1646,1795,2,149,1
11,2,1646,939,4,707,1
54,1,1657,1678,8,21,1
58,2,1667,1668,5,1,0
42,1,1683,1599,4,84,0
116,0,1596,1686,2,90,0
74,1,1769,1659,2,110,0
54,1,1668,1761,2,93,1
85,2,1752,1677,2,75,1
38,1,1688,1743,10,55,1
41,2,1582,1704,3,122,0
121,2,1693,1666,7,27,1
30,1,1676,1680,3,4,1
64,1,1142,1679,3,537,1
15,2,1678,1148,10,530,1
40,1,1154,1676,1,522,1
128,0,1686,1098,2,588,0
48,1,1102,1685,1,583,1
51,2,1684,1107,4,577,1
71,1,1493,1678,2,185,1
60,2,1525,1693,3,168,0
58,1,1709,1681,2,28,0
60,1,1692,1699,2,7,1
40,2,1688,1704,2,16,0
29,2,1699,1497,2,202,1
98,1,1703,1943,2,240,1
71,1,1694,1692,6,2,0
135,0,1696,1564,2,132,0
34,1,1572,1688,5,116,1
60,1,1392,1684,6,292,1
47,1,1707,1696,3,11,0
23,2,1684,1720,7,36,0
78,1,1733,1672,2,61,0
35,2,1721,1736,6,15,0
53,2,1724,1733,4,9,0
120,1,1746,1712,2,34,0
41,2,1741,1496,2,245,1
42,1,1295,1240,7,55,0
63,2,1430,1302,5,128,1
23,1,1302,1248,4,54,0
32,1,1314,1270,5,44,0
73,2,1445,1314,5,131,1
90,1,1321,1451,7,130,1
41,2,1300,1333,6,33,0
43,2,1318,1449,4,131,0
38,1,1450,1303,17,147,0
41,2,1290,1367,5,77,0
84,1,1300,1330,9,30,1
56,1,1209,1291,5,82,1
30,1,1299,1418,6,119,1
6,2,1814,1299,5,515,1
67,2,1348,1308,3,40,1
56,1,1318,1366,5,48,1
103,2,1324,1329,6,5,0
40,1,1345,1187,5,158,0
52,1,1352,1149,5,203,0
57,0,1350,1429,10,79,0
23,2,1403,1340,3,63,1
39,2,1322,1072,5,250,1
52,1,1331,1382,4,51,1
41,2,1373,1341,6,32,1
33,2,1350,1265,5,85,1
58,1,1270,1299,3,29,1
31,2,1223,1282,4,59,0
15,2,1289,1306,8,17,0
32,1,1007,1268,6,261,1
45,2,1170,1179,5,9,0
25,2,1442,1183,8,259,1
15,2,1172,1170,5,2,1
62,1,1178,1346,8,168,1
59,2,1171,1190,9,19,0
51,2,1175,1329,10,154,0
22,1,1273,1160,2,113,0
27,2,1154,974,5,180,1
34,1,1167,1122,6,45,0
79,2,1439,1171,10,268,1
73,2,1245,1170,9,75,1
74,1,1250,1156,1,94,0
92,1,1164,1263,8,99,1
26,1,1173,1251,5,78,1
40,1,1089,1165,6,76,1
77,2,1278,1173,3,105,1
58,1,1178,1391,6,213,1
51,2,1164,1293,10,129,0
73,2,1353,1170,7,183,1
50,1,1030,1162,3,132,1
52,1,1176,1118,4,58,0
11,2,1353,1181,4,172,1
61,2,1184,1184,5,0,0
19,2,1171,1252,5,81,0
51,2,1157,1234,7,77,0
12,1,1034,1149,4,115,1
86,0,1156,886,5,270,0
27,2,1142,1226,3,84,0
86,1,1042,1133,3,91,1
61,2,1123,1084,6,39,1
53,2,1247,1122,3,125,1
50,1,1070,1112,1,42,1
16,2,1099,1173,7,74,0
110,1,1114,1027,5,87,0
45,2,914,1133,5,219,0
93,2,1125,996,5,129,1
105,2,1242,1125,4,117,1
60,1,1133,1234,6,101,1
58,1,981,1127,6,146,1
65,2,1111,1219,7,108,0
56,1,1126,1054,5,72,0
64,1,1147,908,4,239,0
4,1,914,1141,1,227,1
58,1,1984,1948,6,36,0
34,1,1954,2158,3,204,1
101,2,2008,1954,4,54,1
35,1,1954,2008,5,54,1
54,1,2008,1954,2,54,0
116,1,1954,2008,2,54,1
115,2,2100,1960,2,140,1
48,0,1945,1961,6,16,0
56,0,1982,1960,2,22,0
54,1,1974,1899,2,75,0
37,2,2068,1982,11,86,1
81,2,1959,2028,1,69,0
45,2,2005,1969,1,36,1
161,2,1960,1868,2,92,1
88,1,1964,2287,5,323,1
148,0,1914,1965,4,51,0
119,2,1951,2049,2,98,0
60,1,2149,1933,7,216,0
34,1,1599,1929,6,330,1
94,1,1882,1919,6,37,1
122,1,1699,1914,5,215,1
44,1,1916,2285,2,369,1
26,1,1936,1638,5,298,0
116,1,1758,1929,4,171,1
31,2,1265,1957,5,692,0
133,2,1954,1578,9,376,1
65,2,1984,2050,4,66,0
62,1,2050,1627,2,423,0
62,1,1627,2050,3,423,1
42,1,2050,1627,2,423,0
42,1,1627,2050,2,423,1
158,0,1617,2050,5,433,0
31,2,2050,1852,6,198,1
46,1,1981,2050,4,69,1
20,1,2050,1981,9,69,0
73,2,1901,1164,8,737,1
35,2,1164,1435,4,271,0
71,2,1435,1164,7,271,1
46,2,1164,1435,7,271,0
52,1,1164,1901,8,737,1
52,1,1245,1228,5,17,0
70,1,1287,1099,2,188,0
49,2,1866,1099,10,767,1
75,2,1211,1230,2,19,0
61,2,1344,1500,4,156,0
41,2,1834,1500,8,334,1
46,1,1500,1834,5,334,1
53,2,1635,1500,10,135,1
52,1,1456,1604,4,148,1
36,1,1378,1318,3,60,0
64,1,1500,1487,5,13,0
65,2,1714,1709,5,5,1
71,2,1613,1729,9,116,0
50,1,1731,2127,4,396,1
54,1,1739,1840,11,101,1
76,1,1760,1718,7,42,0
61,2,1708,1729,8,21,0
53,2,1721,1643,4,78,1
24,1,1707,1712,7,5,1
64,1,1170,1662,2,492,1
51,2,1261,1237,1,24,1
71,2,1100,1306,3,206,0
49,2,1590,1100,7,490,1
34,1,1100,1590,3,490,1
88,1,1302,875,3,427,0
11,0,1234,1335,4,101,0
11,2,1522,1500,6,22,1
86,1,2306,2405,7,99,1
58,1,2422,2386,8,36,0
50,1,2373,2356,17,17,0
62,1,2325,2338,5,13,1
39,2,2336,1830,9,506,1
49,2,2334,1836,6,498,1
43,2,2329,2017,15,312,1
84,1,1879,2326,6,447,1
41,2,2323,1881,16,442,1
48,1,1622,2322,9,700,1
48,1,1933,2318,10,385,1
38,1,1983,2313,2,330,1
41,2,2312,1663,6,649,1
28,1,1866,2309,2,443,1
74,1,1835,2307,9,472,1
29,2,2300,2041,8,259,1
45,2,2288,2148,4,140,1
61,2,2283,1947,7,336,1
19,2,2275,2016,12,259,1
48,1,1909,2271,8,362,1
41,2,2263,2006,7,257,1
30,1,1293,2263,2,970,1
55,2,2257,1922,9,335,1
72,1,2191,2239,10,48,1
78,1,1380,2239,4,859,1
34,1,1796,2235,4,439,1
56,1,1879,2230,11,351,1
49,2,2217,2059,15,158,1
72,1,2336,2185,10,151,0
70,2,2175,1936,11,239,1
83,2,2161,1984,8,177,1
57,2,2150,1915,6,235,1
39,1,1976,2135,6,159,1
56,1,1830,2126,4,296,1
46,1,2001,2105,6,104,1
31,2,2104,1344,5,760,1
66,1,1918,2086,4,168,1
52,2,2082,1500,7,582,1
100,1,1774,2071,8,297,1
10,1,1778,2059,8,281,1
49,1,1783,2045,10,262,1
100,1,1788,2029,11,241,1
107,2,1609,2109,8,500,0
44,1,1701,2100,3,399,1
27,2,2091,1704,4,387,1
72,1,1931,2061,8,130,1
21,2,1408,1396,4,12,1
91,2,1398,1383,4,15,1
35,2,1387,1399,5,12,0
50,1,1394,1512,4,118,1
56,1,1479,1381,4,98,0
37,2,1371,1374,4,3,0
66,1,1372,1360,4,12,0
40,2,1351,1287,4,64,1
32,1,1209,1265,1,56,1
26,1,1221,1820,3,599,1
89,2,1332,1500,2,168,0
65,1,1528,1369,3,159,0
37,2,1231,1545,8,314,0
48,2,1142,1138,6,4,1
54,1,1263,1264,7,1,1
43,2,1392,1500,2,108,0
60,1,1906,1834,11,72,0
122,1,1841,2015,2,174,1
49,2,1905,1852,2,53,1
56,1,1467,1478,4,11,1
77,2,1478,1500,3,22,0
60,1,1500,1478,1,22,0
33,2,1478,1362,2,116,1
83,2,1478,1490,5,12,0
102,1,1453,1466,6,13,1
29,2,1466,1592,7,126,0
91,2,1466,1582,4,116,0
34,1,1466,1744,9,278,1
59,1,1479,1454,7,25,0
41,2,1566,1493,6,73,1
54,1,1454,1421,6,33,0
43,2,1444,1465,1,21,0
34,1,1387,1457,9,70,1
122,1,1417,1447,3,30,1
51,2,1436,1439,12,3,0
62,1,1455,1081,10,374,0
30,1,1318,1448,10,130,1
79,2,1437,1446,9,9,0
32,1,1448,1436,4,12,0
78,1,1308,1441,5,133,1
82,1,1708,1851,4,143,1
64,1,1960,2260,5,300,1
59,1,1969,2247,5,278,1
62,1,1325,1174,3,151,0
104,1,1325,1500,8,175,1
65,2,1322,913,3,409,1
23,2,1224,1332,3,108,0
50,1,1353,1068,5,285,0
58,1,1131,1347,4,216,1
64,1,1197,1340,2,143,1
56,1,1163,1340,5,177,1
18,1,1362,976,6,386,0
43,2,1348,1381,3,33,0
24,1,1375,1334,6,41,0
125,2,911,1356,2,445,0
104,1,1030,1352,10,322,1
29,2,1352,1408,4,56,0
48,1,2035,1352,4,683,0
65,2,1787,1417,7,370,1
20,1,1810,1495,6,315,0
38,1,1783,1797,2,14,1
26,2,1723,1814,11,91,0
70,1,1645,1806,7,161,1
35,2,1800,1590,5,210,1
23,2,1798,1250,10,548,1
76,1,1602,1791,3,189,1
68,1,1415,1788,3,373,1
4,2,1758,1804,4,46,0
30,1,1815,1889,2,74,1
59,2,1800,1831,4,31,0
77,2,1820,1814,3,6,1
76,1,1830,1809,4,21,0
34,2,1914,1842,8,72,1
53,1,1856,1903,8,47,1
178,0,2153,2474,5,321,0
91,0,2474,2477,7,3,0
57,2,2469,2216,11,253,1
42,1,2220,2464,8,244,1
48,1,1973,2462,8,489,1
33,0,2465,2384,3,81,0
71,2,2460,2240,3,220,1
26,1,2104,2456,6,352,1
32,1,2301,2449,6,148,1
63,2,2447,2005,5,442,1
86,1,2306,2438,8,132,1
99,2,2432,2213,8,219,1
36,1,2255,2425,3,170,1
153,0,2428,2360,15,68,0
112,1,2208,2421,4,213,1
39,2,2418,2067,7,351,1
28,1,2083,2415,2,332,1
65,2,2409,2182,6,227,1
21,1,2281,2400,3,119,1
98,1,2015,2397,9,382,1
31,1,1426,1371,5,55,0
68,1,1437,1476,6,39,1
42,2,1719,1679,6,40,1
42,1,1689,1670,8,19,0
59,2,1672,1701,3,29,0
80,1,1695,1923,11,228,1
31,1,1706,1698,4,8,0
107,2,1687,1717,7,30,0
18,1,1728,1723,8,5,0
72,1,1648,1719,4,71,1
45,2,1719,1765,7,46,0
66,1,1648,1710,4,62,1
93,2,1696,1722,3,26,0
90,1,1732,1768,13,36,1
23,2,1833,1740,6,93,1
118,1,1433,1737,3,304,1
103,0,1729,2008,7,279,0
23,2,1722,1605,8,117,1
91,2,1713,1659,6,54,1
56,1,1605,1698,1,93,1
71,2,1690,1613,3,77,1
48,1,1622,1681,1,59,1
80,1,1702,1681,6,21,0
33,2,1568,1696,8,128,0
84,1,1707,1699,3,8,0
51,2,1453,1724,6,271,0
47,1,1735,1733,5,2,0
74,1,1744,1801,9,57,1
77,1,1854,1730,7,124,0
54,1,1705,1719,6,14,1
75,2,1709,1716,5,7,0
89,2,1694,1825,5,131,0
62,1,1651,1684,3,33,1
49,2,1706,1695,2,11,1
67,2,1683,1717,5,34,0
73,2,1707,1693,2,14,1
43,2,1758,1702,4,56,1
70,1,1713,1709,11,4,0
28,1,1724,1734,7,10,1
16,1,1730,1882,4,152,1
47,2,2334,1800,2,534,1
52,1,1680,1789,2,109,1
43,2,1774,1768,2,6,1
78,1,1711,1760,2,49,1
75,2,1760,1542,4,218,1
105,2,1713,1609,2,104,1
103,2,1710,1618,1,92,1
35,1,1374,1613,6,239,1
45,2,1603,1539,6,64,1
92,0,1564,1603,7,39,0
108,1,1821,1842,11,21,1
154,1,1512,1821,6,309,1
21,2,1821,1832,5,11,0
48,1,1832,1821,7,11,0
89,0,1821,1832,5,11,0
31,2,1832,1821,7,11,1
66,1,1500,1821,5,321,1
80,2,1821,1820,5,1,1
62,2,1500,1821,11,321,0
120,1,1877,1821,11,56,0
38,2,1902,1830,8,72,1
61,2,1830,1311,8,519,1
28,1,1824,1830,3,6,1
99,2,1548,1842,5,294,0
49,1,1858,1730,3,128,0
44,1,1891,1845,6,46,0
55,2,1876,1856,4,20,1
92,1,1867,1883,8,16,1
27,2,1864,1449,4,415,1
98,1,1922,1851,5,71,0
24,1,1861,1899,4,38,1
4,1,1527,1861,1,334,1
16,1,1878,1698,6,180,0
85,2,1878,1906,14,28,0
70,1,1660,1873,4,213,1
36,1,1707,1873,4,166,1
124,0,1806,1875,11,69,0
61,2,1864,1842,5,22,1
66,1,1853,1853,6,0,0
20,1,1882,1840,6,42,0
49,2,1832,1696,4,136,1
42,1,1704,1824,2,120,1
32,1,1841,1688,4,153,0
70,1,1695,1834,2,139,1
52,1,1851,1679,4,172,0
18,1,1527,1882,3,355,1
4,1,1527,1882,1,355,1
54,1,1500,1901,5,401,1
4,1,1533,1897,1,364,1
5,2,1894,1539,1,355,1
26,1,1545,1890,3,345,1
4,1,1552,1887,1,335,1
115,0,1923,1887,3,36,0
100,1,1961,2215,19,254,1
113,2,2215,1961,18,254,1
125,2,2215,2191,8,24,1
51,2,2215,2147,4,68,1
65,1,1803,2215,7,412,1
29,2,2210,1805,7,405,1
26,1,1807,2205,4,398,1
43,2,2200,1810,8,390,1
33,1,1805,2195,2,390,1
54,1,2189,2167,6,22,0
42,1,2051,2147,9,96,1
61,2,2121,2118,7,3,1
38,1,1500,2098,2,598,1
47,2,2078,1920,9,158,1
82,1,2151,2029,8,122,0
47,2,1986,2009,13,23,0
34,1,2143,1916,3,227,0
27,2,1904,1544,5,360,1
32,1,1547,1891,5,344,1
90,1,1950,1926,3,24,0
38,2,1902,1811,1,91,1
51,2,1879,1569,3,310,1
41,2,1805,1749,3,56,1
5,2,1787,1343,2,444,1
44,1,1560,1713,6,153,1
33,2,1500,1569,5,69,0
41,2,1541,1690,7,149,0
28,2,1567,1551,3,16,1
62,1,1540,1540,3,0,0
28,1,1550,1531,10,19,0
61,1,1435,1543,6,108,1
123,2,1534,1467,4,67,1
89,2,1524,1499,4,25,1
43,2,1548,1535,3,13,1
44,1,1545,1554,5,9,1
20,2,2621,1545,6,1076,1
55,1,1544,1523,5,21,0
20,2,1432,1559,3,127,0
88,1,1369,1553,3,184,1
96,1,1553,1542,2,11,0
120,2,1543,1553,3,10,0
111,2,1544,1496,5,48,1
39,2,1519,1556,10,37,0
93,2,1545,1559,3,14,0
100,1,1529,1534,5,5,1
54,1,1546,1517,4,29,0
75,2,1500,1973,3,473,0
160,1,2105,1929,5,176,0
32,2,813,841,3,28,0
86,1,857,1057,5,200,1
50,1,857,958,3,101,1
39,2,1478,859,2,619,1
31,2,859,1500,4,641,0
29,2,1574,861,8,713,1
27,2,1186,871,2,315,1
57,2,1391,875,5,516,1
68,2,1271,883,2,388,1
95,2,1203,894,4,309,1
40,1,901,1339,2,438,1
27,2,1500,901,2,599,1
78,1,922,1120,3,198,1
74,1,989,791,3,198,0
4,1,1026,1121,2,95,1
44,1,1057,1240,2,183,1
45,1,1057,1341,3,284,1
15,2,1331,1083,3,248,1
37,2,1266,1130,2,136,1
22,1,1155,1484,4,329,1
58,1,1222,1351,2,129,1
33,2,1214,1222,2,8,0
41,2,1034,1222,4,188,0
46,2,1535,1273,3,262,1
36,1,1500,1409,2,91,0
55,2,1950,2212,1,262,0
49,2,1950,1226,2,724,1
78,1,1950,1885,4,65,0
29,0,1950,2204,2,254,0
65,0,1950,1500,2,450,0
66,0,1950,1819,4,131,0
112,0,1950,1477,2,473,0
70,0,1950,1500,3,450,0
50,1,2036,1706,6,330,0
40,1,1795,2036,6,241,1
33,2,2023,1671,2,352,1
30,1,1675,2008,8,333,1
53,2,1990,1678,2,312,1
30,0,1990,1465,5,525,0
11,0,1990,1756,2,234,0
3,0,1990,1779,2,211,0
67,0,1990,1447,2,543,0
41,1,1458,1980,4,522,1
28,2,1967,1500,2,467,1
52,2,1967,1295,3,672,1
30,1,2102,1967,6,135,0
62,1,1647,1566,4,81,0
35,2,1500,1647,5,147,0
89,1,1668,1642,4,26,0
119,2,1613,1694,5,81,0
21,2,1500,1500,3,0,0
65,2,1528,1500,3,28,1
50,1,1500,1412,7,88,0
60,1,1887,1760,3,127,0
73,2,1826,1900,16,74,0
42,1,1297,1500,1,203,1
58,1,1297,1230,3,67,0
38,1,1625,1754,3,129,1
28,1,1719,1625,9,94,0
26,1,1625,1657,9,32,1
35,2,1619,1625,5,6,0
35,2,1551,1625,9,74,0
34,1,1862,1358,5,504,0
38,1,1807,1862,9,55,1
27,1,1862,1387,1,475,0
80,1,1474,1862,5,388,1
54,1,1862,1807,5,55,0
65,2,1720,1862,8,142,0
55,1,1862,1690,2,172,0
67,1,1884,1862,5,22,0
78,1,1396,1862,8,466,1
51,2,1674,1862,4,188,0
75,2,2203,1862,6,341,1
36,1,1862,2203,10,341,1
58,1,1862,1722,6,140,0
12,2,1598,1862,5,264,0
21,2,1708,1862,5,154,0
56,1,1862,1500,1,362,0
24,1,1862,1513,4,349,0
32,1,1500,1862,6,362,1
66,1,1862,1449,16,413,0
45,1,1862,1500,4,362,0
50,2,1704,1862,6,158,0
18,1,1862,1769,7,93,0
90,1,1701,1862,6,161,1
75,2,1799,1862,4,63,0
34,1,1862,1701,4,161,0
70,1,1699,1862,6,163,1
24,1,1862,1579,6,283,0
18,1,1862,1416,5,446,0
36,1,1862,2073,5,211,1
99,2,1567,1862,3,295,0
60,2,1564,1862,2,298,0
77,2,1862,1140,8,722,1
74,1,1972,1952,7,20,0
61,2,1960,1950,5,10,1
15,2,2199,1955,7,244,1
102,0,1955,1837,11,118,0
129,2,1937,2090,5,153,0
25,2,1951,1664,5,287,1
39,2,1944,1776,8,168,1
62,1,1553,1942,5,389,1
19,1,1236,1941,2,705,1
83,2,1500,1500,3,0,0
66,2,1500,1500,5,0,0
89,2,1500,1500,3,0,0
129,0,1500,1500,1,0,0
27,2,1500,1500,2,0,0
76,2,1500,1500,2,0,0
55,2,1452,1343,6,109,1
65,2,1343,1376,4,33,0
63,2,1803,1737,5,66,1
64,1,1670,1692,5,22,1
69,2,1500,1534,3,34,0
31,2,1500,1421,3,79,1
15,2,1500,1329,5,171,1
35,2,1851,1712,6,139,1
107,2,1712,1714,7,2,0
43,2,1500,1712,2,212,0
72,1,1705,1712,3,7,1
63,1,1712,2015,7,303,1
34,1,1712,1832,2,120,1
51,1,1712,1615,4,97,0
60,1,1712,1708,4,4,0
26,1,1860,1712,3,148,0
70,1,2108,1712,7,396,0
24,1,1712,1959,4,247,1
124,1,1712,1500,4,212,0
39,2,1780,1712,8,68,1
58,1,2180,1712,3,468,0
16,1,1328,1712,1,384,1
52,1,1896,1712,7,184,0
22,1,1500,1591,5,91,1
43,2,1582,1494,7,88,1
27,2,1726,1589,5,137,1
41,2,1577,1618,2,41,0
30,1,1577,1534,2,43,0
125,2,1693,1585,7,108,1
16,2,1573,1590,2,17,0
53,2,1597,1583,3,14,1
49,2,1603,1594,3,9,1
59,2,1586,1623,2,37,0
86,1,1592,1783,2,191,1
52,1,1602,1629,1,27,1
96,1,1516,1593,2,77,1
114,1,1475,1585,3,110,1
69,2,1575,1571,5,4,1
40,1,1585,1632,2,47,1
72,2,2065,1976,6,89,1
63,2,1976,1988,10,12,0
141,2,1976,1987,4,11,0
92,1,2035,1961,6,74,0
64,1,1975,1908,8,67,0
90,1,1463,1974,3,511,1
70,1,1997,1480,7,517,0
68,1,1950,1997,2,47,1
63,2,2229,2002,10,227,1
63,2,1819,2020,3,201,0
75,2,2014,1827,8,187,1
94,1,1807,2008,4,201,1
102,1,2013,2274,3,261,1
87,2,2008,1744,2,264,1
90,1,2179,1991,10,188,0
96,0,1777,1998,5,221,0
33,2,1982,1917,3,65,1
52,1,1749,1977,4,228,1
62,1,1781,1971,8,190,1
63,2,2040,1981,10,59,1
132,1,1890,2139,4,249,1
55,2,2131,2018,10,113,1
95,2,2116,2252,8,136,0
59,2,1687,1691,12,4,0
86,1,1689,1668,3,21,0
150,1,1651,1657,3,6,1
54,1,1500,1990,10,490,1
74,1,1786,1736,7,50,0
33,2,1663,1758,4,95,0
161,2,1779,1794,2,15,0
85,2,1500,1688,4,188,0
76,1,1654,1918,8,264,1
52,1,1690,1913,5,223,1
204,1,1818,1896,6,78,1
26,1,1813,1887,11,74,1
64,1,1775,1879,3,104,1
47,2,1873,1651,4,222,1
103,2,1868,1656,5,212,1
39,2,1860,1770,5,90,1
50,1,1748,1852,3,104,1
19,1,1365,1850,3,485,1
30,1,1861,1873,11,12,1
35,2,1833,1873,3,40,0
46,1,1821,1873,5,52,1
35,2,2004,1881,5,123,1
32,1,1895,1797,5,98,0
52,1,1560,1892,3,332,1
132,1,1901,1993,5,92,1
38,1,1729,1894,2,165,1
86,1,1613,1891,3,278,1
43,2,1864,1892,8,28,0
34,1,1905,1851,9,54,0
72,1,1784,1897,4,113,1
23,2,1893,1624,6,269,1
78,1,1750,1885,4,135,1
45,2,1882,1602,6,280,1
66,1,1712,1875,5,163,1
29,2,1878,1887,10,9,0
154,1,1895,1977,10,82,1
80,1,1672,1890,4,218,1
121,2,1881,1828,3,53,1
140,0,1972,1878,9,94,0
75,2,1868,1824,3,44,1
36,2,1819,1881,10,62,0
77,2,1871,1841,4,30,1
33,2,1828,1884,3,56,0
56,1,1727,1877,4,150,1
129,1,1891,1814,13,77,0
53,2,1650,1910,4,260,0
22,2,1968,1921,6,47,1
51,2,1907,1946,8,39,0
37,2,1903,1648,6,255,1
30,1,1725,1896,3,171,1
89,2,1894,1506,5,388,1
73,2,1890,1617,8,273,1
114,1,1522,1727,13,205,1
107,2,1708,1528,4,180,1
92,1,1744,1770,7,26,1
63,2,1759,1790,4,31,0
36,1,1750,1741,6,9,0
55,2,1686,1681,6,5,1
85,2,1840,1732,4,108,1
118,1,1713,1637,3,76,0
55,2,1791,1716,3,75,1
135,0,1716,1763,4,47,0
78,1,1804,1931,3,127,1
40,1,1850,1804,5,46,0
114,0,1804,1779,7,25,0
68,1,1701,1500,5,201,0
48,1,1005,1140,6,135,1
29,2,1148,1057,3,91,1
14,1,1142,1150,6,8,1
61,2,1066,1326,7,260,0
59,2,1625,1384,6,241,1
9,2,1805,1384,5,421,1
80,1,1500,1644,1,144,1
81,1,1687,1771,3,84,1
103,2,1678,1595,2,83,1
10,1,2313,2168,2,145,0
32,1,1855,2313,6,458,1
50,0,2353,2313,5,40,0
41,2,2291,2144,10,147,1
39,2,2272,2061,9,211,1
50,1,2344,2215,6,129,0
66,1,2063,2183,6,120,1
66,2,2109,2247,5,138,0
55,2,2062,1978,8,84,1
65,2,1996,1957,9,39,1
72,1,1968,1882,16,86,0
57,2,1756,1771,8,15,0
50,1,1785,1432,5,353,0
57,2,1432,1916,5,484,0
21,2,1870,1479,6,391,1
48,1,1859,1479,6,380,0
49,2,2108,1500,3,608,1
68,1,1299,1513,1,214,1
40,1,1501,1513,6,12,1
9,1,1513,1501,4,12,0
36,1,1126,1513,3,387,1
98,1,1286,1502,9,216,1
56,1,1433,1481,4,48,1
128,0,1406,1481,7,75,0
132,1,1510,1461,4,49,0
48,1,1534,1581,4,47,1
57,2,1547,1564,8,17,0
75,1,1602,1502,1,100,0
99,2,1444,1651,7,207,0
59,2,1627,1496,4,131,1
56,1,1267,1627,3,360,1
69,2,1604,1446,9,158,1
70,1,1453,1576,4,123,1
77,2,1740,1500,2,240,1
64,1,1552,1625,7,73,1
70,1,1810,1473,2,337,0
75,2,1436,1484,10,48,0
104,0,1638,1417,2,221,0
63,2,2053,1914,4,139,1
67,2,2021,1921,4,100,1
40,1,1930,1979,3,49,1
80,1,2000,1908,4,92,0
99,2,1885,1607,2,278,1
120,1,1776,1821,2,45,1
9,0,1845,1750,9,95,0
62,1,1707,1734,1,27,1
59,2,1500,1603,6,103,0
57,2,1185,1222,1,37,0
72,1,1230,1334,6,104,1
115,2,1262,1240,4,22,1
70,1,1250,1286,6,36,1
29,2,1133,1264,4,131,0
33,2,1257,1141,6,116,1
17,2,1279,1267,11,12,1
19,2,1315,1264,4,51,1
100,1,1277,1173,3,104,0
27,2,1332,1287,8,45,1
95,0,1291,1166,4,125,0
75,2,1194,1308,7,114,0
44,1,1136,1301,3,165,1
87,2,1291,1262,4,29,1
29,2,1286,1083,5,203,1
75,2,1278,1173,3,105,1
52,1,1175,1270,4,95,1
40,1,1173,1262,3,89,1
73,2,1329,1271,5,58,1
64,1,1282,1285,4,3,1
52,1,1235,1272,1,37,1
26,1,1284,1261,8,23,0
13,2,1279,1036,4,243,1
104,1,1239,1269,3,30,1
55,2,1152,1284,4,132,0
57,2,1277,1122,3,155,1
97,2,1264,1327,11,63,0
17,2,1442,1270,8,172,1
23,2,1260,1233,9,27,1
54,2,1767,1260,5,507,1
72,1,1268,1392,6,124,1
34,1,1259,1417,8,158,1
56,1,1263,1587,8,324,1
84,1,1342,1248,4,94,0
29,2,1783,1249,8,534,1
19,1,1257,1380,4,123,1
144,1,1265,1366,6,101,1
110,1,1016,1262,2,246,1
47,2,1247,1380,8,133,0
37,2,1662,1501,6,161,1
60,0,1542,1501,7,41,0
54,1,1199,1501,4,302,1
137,2,1501,1199,6,302,1
81,2,1199,1501,4,302,0
83,2,1501,1500,4,1,1
53,2,1597,1501,5,96,1
65,2,1501,1619,6,118,0
8,1,1567,1501,6,66,0
55,2,1585,1501,6,84,1
67,2,1501,1590,4,89,0
26,1,1501,1640,8,139,1
33,2,1702,1501,9,201,1
73,2,1514,1501,3,13,1
27,1,1501,1500,5,1,0
50,1,1501,1511,5,10,1
74,1,1500,1501,8,1,1
130,0,1501,1760,3,259,0
14,1,1501,1787,7,286,1
51,2,1694,1501,3,193,1
24,1,1501,1503,2,2,1
94,1,1694,1501,3,193,0
24,1,1501,1606,7,105,1
57,2,1500,1501,1,1,0
19,2,1500,1501,4,1,0
47,2,1787,1501,7,286,1
30,1,1501,1646,5,145,1
17,2,1707,1501,3,206,1
18,1,1501,1500,7,1,0
24,2,1645,1501,9,144,1
7,2,1501,1797,6,296,0
27,2,1501,1501,3,0,0
50,1,1501,1626,4,125,1
20,1,1501,1759,3,258,1
85,2,1500,1501,7,1,0
87,2,1501,1500,4,1,1
45,2,1501,1513,5,12,0
63,2,1501,1509,5,8,0
38,1,1500,1501,6,1,1
39,2,1585,1501,5,84,1
8,1,1501,1609,5,108,1
90,1,1501,1500,5,1,0
94,2,1501,1500,8,1,1
29,2,1598,1501,4,97,1
98,1,1104,910,6,194,0
74,1,1104,1207,2,103,1
37,2,1104,1343,2,239,0
74,1,1104,1500,4,396,1
6,2,1104,1228,2,124,0
94,1,1104,1419,6,315,1
29,2,1104,1069,2,35,1
68,1,1104,1300,5,196,1
50,2,1104,1500,2,396,0
38,1,1104,1248,1,144,1
28,1,1104,1226,2,122,1
82,2,1104,1139,4,35,0
18,2,1104,1337,2,233,0
63,2,1104,1017,5,87,1
58,1,1104,1290,2,186,1
44,1,1273,1104,5,169,0
35,2,1500,1104,5,396,1
87,2,1481,1104,5,377,1
64,1,1104,1500,3,396,1
36,1,1500,1104,3,396,0
29,2,1356,1104,7,252,1
93,2,1024,1104,4,80,0
57,2,1336,1104,2,232,1
53,2,1500,1104,1,396,1
42,1,1104,1430,2,326,1
51,2,1430,1104,9,326,1
77,2,1408,1104,5,304,1
21,2,1408,1104,7,304,1
43,2,1499,1104,3,395,1
81,2,1412,1104,5,308,1
94,1,1072,1231,4,159,1
92,1,1245,1264,3,19,1
29,2,1233,1174,3,59,1
78,1,1251,1177,3,74,0
124,0,1174,1254,3,80,0
59,2,1225,1252,8,27,0
11,2,1216,1041,6,175,1
66,1,1007,1208,4,201,1
58,1,1226,1198,5,28,0
41,2,1277,1241,2,36,1
49,2,1233,1013,3,220,1
45,2,1225,1014,3,211,1
110,1,1026,1215,6,189,1
52,0,1339,1339,3,0,0
17,2,1390,1339,3,51,1
98,1,1339,1243,4,96,0
68,1,1327,1327,1,0,0
52,1,1327,1490,7,163,1
29,2,1444,1327,3,117,1
39,2,1327,1391,4,64,0
7,2,1500,1327,5,173,1
32,1,1500,1327,3,173,0
97,2,1313,1360,7,47,0
14,2,1500,1313,2,187,1
26,2,958,1313,6,355,0
38,1,1313,1500,3,187,1
11,2,1223,1313,1,90,0
84,2,1291,1313,4,22,0
9,2,1313,1500,6,187,0
9,2,1500,1313,4,187,1
33,2,1313,1239,4,74,1
56,1,1313,1500,3,187,1
17,2,1428,1313,4,115,1
73,2,1313,1078,4,235,1
35,2,1307,1313,4,6,0
30,1,1313,1500,4,187,1
27,2,1313,1399,6,86,0
77,2,1412,1313,4,99,1
31,2,1563,1318,6,245,1
30,1,1327,1420,3,93,1
87,2,1412,1337,2,75,1
43,2,1337,1382,4,45,0
60,1,1382,1337,4,45,0
36,1,1337,1382,3,45,1
77,2,1516,1345,6,171,1
56,1,1418,2003,4,585,1
44,1,2003,1418,4,585,0
31,2,1418,2003,10,585,0
54,1,1787,1749,6,38,0
40,1,1802,1691,3,111,0
18,2,1799,1408,5,391,1
137,2,2019,1805,6,214,1
38,1,1812,1949,15,137,1
73,2,1757,1825,6,68,0
141,2,2150,1829,3,321,1
124,1,1766,1819,6,53,1
76,1,1827,1933,3,106,1
50,1,1834,1994,6,160,1
48,1,1590,1829,8,239,1
76,1,1844,1731,10,113,0
55,2,1723,1859,2,136,0
67,2,1853,1675,6,178,1
110,0,1859,1674,11,185,0
98,1,1834,1848,3,14,1
48,1,1804,1837,3,33,1
86,1,1850,1811,9,39,0
47,2,1834,1856,3,22,0
104,1,1526,1830,8,304,1
168,1,1843,1818,3,25,0
154,1,1844,1713,7,131,0
90,0,1845,1844,2,1,0
73,2,1728,1859,1,131,0
26,1,1865,2076,13,211,1
79,2,2096,1870,3,226,1
71,2,1860,1800,10,60,1
102,1,1610,1856,7,246,1
75,2,1846,1778,11,68,1
77,0,1936,1843,11,93,0
23,2,1842,1300,9,542,1
34,1,1862,1556,6,306,0
78,1,1865,1850,12,15,0
69,1,1785,1840,2,55,1
74,1,1771,1831,2,60,1
56,1,1844,1793,6,51,0
78,1,1848,2098,10,250,1
74,1,1789,1838,5,49,1
27,2,1820,2095,6,275,0
60,1,1891,1805,8,86,0
79,2,1785,2116,6,331,0
49,2,1769,1926,9,157,0
40,2,1967,1775,5,192,1
56,1,1711,1766,1,55,1
41,2,1754,1768,10,14,0
51,2,1756,1765,6,9,0
60,1,1778,1757,3,21,0
113,2,1225,1086,4,139,1
30,0,1211,1226,6,15,0
50,1,1243,1200,4,43,0
114,1,1256,1298,7,42,1
42,1,1312,1237,6,75,0
54,1,1245,1237,4,8,0
108,2,1335,1237,9,98,1
55,2,1237,1335,2,98,0
79,2,1335,1237,5,98,1
44,1,1237,1326,6,89,1
66,1,1253,1262,6,9,1
51,2,1227,1303,9,76,0
53,2,1214,1115,6,99,1
53,2,1197,1190,2,7,1
60,1,1176,1658,4,482,1
17,1,1678,1017,5,661,0
124,2,2186,1017,5,1169,1
125,2,1108,1017,5,91,1
39,2,2008,1017,7,991,1
42,1,1362,2089,3,727,1
38,1,1362,1657,5,295,1
30,2,1657,1362,3,295,1
4,2,1804,1372,4,432,1
50,1,1453,1466,10,13,1
53,2,1414,1182,6,232,1
59,2,1171,1432,7,261,0
23,0,1697,1171,5,526,0
117,0,1705,1628,5,77,0
88,1,1567,1698,7,131,1
39,2,1401,1467,2,66,0
29,0,1401,1588,2,187,0
29,1,1588,1401,11,187,0
68,1,1401,2252,8,851,1
62,1,1413,1401,2,12,0
58,1,1539,1397,3,142,0
115,2,1445,1407,5,38,1
52,2,1394,1659,4,265,0
57,2,1383,1384,2,1,0
105,2,1397,1394,6,3,1
56,1,1405,1402,2,3,0
53,2,1430,1416,4,14,1
91,2,1467,1426,6,41,1
39,2,1426,1500,6,74,0
64,1,1500,1426,3,74,0
50,2,1426,1207,5,219,1
27,1,1549,1426,2,123,0
56,1,1464,1413,1,51,0
39,2,1413,1500,3,87,0
62,1,1500,1413,4,87,0
58,1,1413,1500,9,87,1
45,2,1688,1413,4,275,1
48,1,1220,1407,6,187,1
48,2,1500,1407,5,93,1
26,1,1407,1459,10,52,1
32,1,1500,1407,1,93,0
41,2,1430,1407,3,23,1
23,2,2139,1407,5,732,1
48,1,1259,1184,4,75,0
67,2,1162,1273,6,111,0
32,1,1288,1138,4,150,0
7,1,1154,1191,2,37,1
24,1,1159,1474,7,315,1
23,2,1217,1176,2,41,1
20,1,1205,1257,3,52,1
122,1,1210,1183,3,27,0
57,2,1396,1131,4,265,1
19,2,1237,1565,9,328,0
98,1,1753,1451,4,302,0
35,2,1699,1457,4,242,1
41,2,1699,1500,8,199,1
75,2,1500,1545,3,45,0
122,1,1364,1356,3,8,0
8,1,1374,1385,4,11,1
90,1,1324,1365,7,41,1
46,1,1376,1370,6,6,0
29,1,1340,1366,1,26,1
51,2,1278,1380,6,102,0
39,0,1250,1382,2,132,0
94,1,1388,1238,6,150,0
129,2,1301,1401,2,100,0
129,2,1390,1423,5,33,0
38,1,1403,1321,4,82,0
68,1,1384,1393,3,9,1
56,1,1403,1387,3,16,0
88,1,1381,1393,2,12,1
86,1,1405,1362,4,43,0
107,0,1397,1405,3,8,0
57,2,1397,1327,7,70,1
13,2,1374,1408,1,34,0
82,1,1414,1594,4,180,1
63,2,1306,1429,2,123,0
40,1,1423,1610,6,187,1
42,2,1463,1432,1,31,1
50,2,1440,1443,8,3,0
25,2,1432,1456,11,24,0
88,1,1437,1635,3,198,1
62,1,1412,1427,2,15,1
48,1,1443,1415,8,28,0
30,1,1418,1404,4,14,0
110,1,1261,1397,2,136,1
60,1,1406,1458,6,52,1
39,2,1349,1419,7,70,0
63,2,1412,1305,6,107,1
40,1,1424,1356,6,68,0
15,2,1413,1434,2,21,0
47,2,1408,1184,7,224,1
44,2,1500,1414,2,86,1
86,1,1343,1406,2,63,1
73,2,1697,1592,2,105,1
80,1,1693,2287,3,594,1
117,0,1588,1696,1,108,0
41,2,1596,1711,3,115,0
94,1,1721,1754,4,33,1
63,2,1721,1857,5,136,0
80,1,1735,1649,4,86,0
67,0,1731,1879,8,148,0
116,1,1643,1722,5,79,1
130,1,1228,1732,3,504,1
73,2,1716,1856,8,140,0
93,2,1710,1712,12,2,0
94,1,1828,1694,4,134,0
33,2,1685,1609,2,76,1
47,2,1472,1445,5,27,1
23,2,1472,1500,5,28,0
84,2,1472,1218,3,254,1
6,2,1161,1472,3,311,0
88,1,1493,1315,2,178,0
35,2,1493,1500,3,7,0
78,1,1463,1493,4,30,1
61,2,1493,1463,3,30,1
113,0,1744,1482,4,262,0
78,1,1482,1744,3,262,1
31,2,1500,1482,4,18,1
49,2,1477,1189,3,288,1
82,1,1476,1474,5,2,0
115,2,1476,1524,4,48,0
59,2,1500,1170,3,330,1
82,1,1170,1500,3,330,1
22,1,1229,1160,3,69,0
49,2,1219,1229,5,10,0
45,2,1659,1500,6,159,1
10,1,1032,1140,5,108,1
88,1,1037,1669,2,632,1
33,2,1147,1121,5,26,1
69,2,1209,1261,4,52,0
84,1,1500,1311,2,189,0
70,1,1500,1473,5,27,0
74,2,2352,2366,7,14,0
161,2,2351,2363,5,12,0
62,1,1500,1758,9,258,1
39,2,1724,1605,3,119,1
91,2,1364,1327,8,37,1
53,2,1327,1355,6,28,0
35,2,1367,1343,5,24,1
52,1,1361,1370,5,9,1
66,1,1327,1343,6,16,1
111,2,1347,1186,7,161,1
27,2,1334,1400,3,66,0
19,1,1348,1322,6,26,0
27,1,1329,1466,3,137,1
25,2,1295,1821,4,526,0
102,1,1329,1282,7,47,0
60,1,1285,1598,3,313,1
62,1,1099,1279,3,180,1
130,0,1275,1398,3,123,0
61,2,1350,1285,7,65,1
63,2,1383,1286,7,97,1
50,1,1297,1313,5,16,1
26,1,1273,1286,8,13,1
33,2,1282,1018,5,264,1
17,2,1231,1295,11,64,0
32,1,1306,1298,8,8,0
92,1,1195,1298,1,103,1
47,2,1383,1307,4,76,1
25,2,1296,1284,3,12,1
71,2,1600,1300,6,300,1
57,2,1282,1492,4,210,0
43,0,1386,1279,1,107,0
17,2,1264,1367,6,103,0
51,2,1393,1272,4,121,1
24,1,1278,1474,4,196,1
39,2,1267,1370,4,103,0
49,2,1349,1276,3,73,1
40,1,1285,1383,3,98,1
95,2,1526,1290,1,236,1
45,2,1460,1296,10,164,1
64,1,1299,1647,3,348,1
51,2,1279,1625,7,346,0
43,2,1455,1272,8,183,1
29,2,1253,1472,6,219,0
23,1,1258,1481,4,223,1
53,2,1500,1509,5,9,0
25,2,2165,1973,6,192,1
78,1,2179,2115,1,64,0
52,1,1857,2176,4,319,1
83,2,2173,1831,3,342,1
41,0,2177,2051,9,126,0
101,2,2156,2181,5,25,0
37,2,2175,1983,14,192,1
106,1,1856,2171,3,315,1
56,1,2030,2164,3,134,1
124,1,2179,2090,2,89,0
32,1,1450,1390,5,60,0
67,2,1507,1497,7,10,1
42,1,1511,1490,8,21,0
78,1,1402,1465,7,63,1
100,1,1492,1560,2,68,1
64,2,1558,1526,3,32,1
53,2,1491,1438,5,53,1
71,2,1447,1439,2,8,1
41,2,1455,1506,4,51,0
77,2,1570,1565,8,5,1
7,2,1238,1500,3,262,0
7,2,1500,1238,3,262,1
4,1,1500,1238,1,262,0
18,1,1500,1238,3,262,0
23,2,1443,1500,5,57,0
12,1,1500,1626,3,126,1
60,1,1319,1214,4,105,0
54,1,1278,1308,2,30,1
28,1,1317,1401,7,84,1
32,2,1258,1331,2,73,0
65,2,1320,1291,4,29,1
33,1,1331,1347,8,16,1
104,1,1340,1433,2,93,1
127,0,1134,1346,2,212,0
73,2,1336,1292,2,44,1
106,1,1515,1319,3,196,0
40,1,1295,1308,5,13,1
45,2,1295,1321,2,26,0
117,2,1278,1463,3,185,0
123,2,1363,1287,2,76,1
45,2,1275,1287,4,12,0
89,2,1201,1290,10,89,0
73,2,1214,925,5,289,1
105,2,966,937,2,29,1
8,1,951,955,3,4,1
61,2,784,970,3,186,0
101,2,1161,958,4,203,1
96,1,972,985,6,13,1
79,2,1148,972,4,176,1
16,1,972,1301,3,329,1
13,2,1181,978,2,203,1
21,2,958,1008,3,50,0
28,0,1015,956,3,59,0
46,1,972,954,3,18,0
110,1,983,1090,2,107,1
105,2,964,1029,3,65,0
66,1,1058,943,3,115,0
47,2,808,973,1,165,0
11,2,1095,986,4,109,1
62,1,999,1092,1,93,1
13,2,912,1024,4,112,0
132,1,1032,1274,5,242,1
112,1,1199,1002,5,197,0
20,1,1029,914,1,115,0
128,1,1048,1077,1,29,1
33,2,1082,1070,2,12,1
141,2,1044,1080,2,36,0
30,2,1070,1069,2,1,1
107,2,1206,1069,3,137,1
48,1,1099,1052,6,47,0
6,1,1062,1071,4,9,1
19,2,1038,1074,6,36,0
53,2,1266,1053,2,213,1
63,1,1099,1326,3,227,1
42,1,1141,1168,3,27,1
44,0,954,1166,2,212,0
21,0,1196,946,2,250,0
37,0,937,1233,2,296,0
39,2,1638,940,7,698,1
105,2,1649,1672,3,23,0
80,1,1676,1637,3,39,0
39,2,1711,1645,5,66,1
90,1,1655,1668,4,13,1
41,1,1666,1647,4,19,0
69,1,1645,1655,5,10,1
21,1,1591,1647,2,56,1
103,2,1648,1672,5,24,0
79,2,1595,1660,6,65,0
31,2,1671,1671,3,0,0
25,2,1660,1665,5,5,0
31,2,1682,1670,3,12,1
140,1,1683,1621,10,62,0
148,1,1693,1693,4,0,0
87,2,1730,1703,6,27,1
41,2,1799,1711,3,88,1
80,1,1143,1711,5,568,1
90,1,1686,1701,6,15,1
47,1,1711,1724,6,13,1
97,2,1701,1680,3,21,1
101,2,1964,1705,3,259,1
108,1,1720,1566,4,154,0
132,1,1728,1798,5,70,1
94,1,1755,1717,5,38,0
43,2,1704,1775,7,71,0
61,2,1772,1713,6,59,1
41,2,1699,1800,7,101,0
64,1,1610,1691,5,81,1
61,2,1679,1730,4,51,0
58,1,1576,1671,3,95,1
33,2,1661,1675,3,14,0
54,1,1661,1618,8,43,0
60,1,1748,1647,5,101,0
141,2,1637,1661,4,24,0
57,1,1540,1629,6,89,1
127,2,1620,1549,8,71,1
103,2,1535,1634,5,99,0
71,2,1347,1268,1,79,1
61,2,1400,1500,5,100,0
60,1,1500,1072,5,428,0
73,2,1258,1362,3,104,0
80,1,1088,1350,5,262,1
108,1,1297,1330,4,33,1
72,2,1605,1367,3,238,1
100,1,1420,1620,3,200,1
105,0,1621,1325,7,296,0
98,1,1500,1501,4,1,1
35,2,1576,1539,5,37,1
29,2,1191,1598,3,407,0
41,2,1595,1223,6,372,1
95,2,1301,1616,4,315,0
79,2,1611,1371,4,240,1
46,1,1383,1606,6,223,1
81,1,1498,1597,7,99,1
69,1,1355,1592,3,237,1
76,1,1593,2216,7,623,1
108,1,1532,1583,6,51,1
75,2,1569,1349,5,220,1
87,2,1728,1576,6,152,1
111,2,1560,1686,3,126,0
40,2,1550,1482,7,68,1
60,1,1553,1953,5,400,1
109,2,1775,1558,9,217,1
31,2,1549,1570,5,21,0
60,1,1577,1874,4,297,1
52,1,1276,1573,4,297,1
87,1,1585,1569,5,16,0
26,1,1408,1579,4,171,1
63,2,1575,1281,4,294,1
101,0,1814,1568,4,246,0
80,1,1585,1697,3,112,1
71,2,1574,1561,6,13,1
174,1,1528,1564,7,36,1
123,2,1651,1573,5,78,1
99,2,1569,1298,5,271,1
114,1,1390,1201,3,189,0
57,2,1349,1403,6,54,0
29,2,1418,1415,3,3,1
45,2,1403,1403,8,0,0
9,2,1395,1273,2,122,1
102,1,1408,1393,4,15,0
114,1,1345,1398,7,53,1
67,2,1545,1405,5,140,1
128,1,1410,1629,8,219,1
12,1,1500,1378,3,122,0
52,1,1232,1371,1,139,1
109,0,1372,1347,5,25,0
22,1,1384,1353,5,31,0
41,2,1285,1400,4,115,0
50,1,1412,1433,8,21,1
60,1,1416,1699,4,283,1
93,2,1406,1338,5,68,1
92,1,1564,1389,5,175,0
56,1,1102,1385,3,283,1
122,1,1243,1378,2,135,1
111,2,1586,1383,5,203,1
68,1,1045,1383,4,338,1
42,1,1383,1045,3,338,0
26,1,1383,1045,3,338,0
77,2,1383,1045,3,338,1
45,2,1383,1045,3,338,1
112,0,1383,1045,3,338,0
52,1,1383,1045,3,338,0
98,1,1500,1503,3,3,1
89,2,1980,1860,11,120,1
59,2,1171,1432,7,261,0
113,2,1403,1364,3,39,1
62,1,1446,1359,3,87,0
58,1,1369,1413,3,44,1
12,1,1468,1354,3,114,0
84,1,1331,1434,3,103,1
33,2,1985,1009,6,976,1
63,2,1227,1009,4,218,1
41,2,1009,1227,3,218,0
69,2,1344,1018,1,326,1
92,1,1018,1707,2,689,1
20,1,1018,1489,4,471,1
16,1,1018,1387,5,369,1
81,2,1500,1018,6,482,1
31,2,998,835,5,163,1
45,2,1055,1034,5,21,1
19,2,1166,1034,5,132,1
19,2,1100,1034,7,66,1
88,0,1009,1038,2,29,0
124,1,1500,1038,3,462,0
2,1,1038,1331,2,293,1
13,2,1653,1038,4,615,1
12,2,1038,1265,4,227,0
25,2,955,1038,2,83,0
46,1,1063,1779,3,716,1
26,2,1067,972,1,95,1
24,1,1072,1815,4,743,1
49,2,1324,1096,6,228,1
40,1,1150,1202,1,52,1
29,2,1918,1150,6,768,1
137,2,1352,1629,5,277,0
14,0,1352,1364,3,12,0
60,2,1353,1364,5,11,0
44,1,1377,1340,2,37,0
34,1,1351,1366,3,15,1
40,1,1363,1353,3,10,0
113,2,1403,1364,3,39,1
38,0,1323,1365,3,42,0
90,1,1287,1355,2,68,1
37,2,1345,1296,3,49,1
44,1,1331,1341,2,10,1
34,1,1343,1328,4,15,0
34,1,1343,1328,4,15,0
157,2,1293,1342,4,49,0
45,1,1210,1334,1,124,1
31,2,1325,1218,2,107,1
102,1,1690,1712,1,22,1
32,1,1763,1628,1,135,0
79,2,1776,1880,6,104,0
29,2,1840,1785,4,55,1
75,2,1786,1795,11,9,0
66,1,1711,1751,3,40,1
39,2,1848,1857,12,9,0
44,1,1865,1990,4,125,1
38,1,1880,1828,9,52,0
48,1,1835,1868,6,33,1
83,2,1854,1871,3,17,0
45,2,1805,1870,3,65,0
132,0,1873,1803,6,70,0
55,0,1989,1868,8,121,0
82,1,1884,1830,6,54,0
100,1,1839,1871,3,32,1
142,1,1844,1857,3,13,1
85,2,1844,1809,7,35,1
54,1,1832,1829,12,3,0
80,1,1844,1839,4,5,0
99,0,1845,1841,4,4,0
100,1,1837,1828,5,9,0
51,2,1810,1835,4,25,0
69,2,1981,1818,1,163,1
106,1,1805,1800,6,5,0
58,1,1815,1893,4,78,1
63,2,1946,1828,4,118,1
48,1,1843,1938,2,95,1
64,1,1859,1945,6,86,1
57,2,1825,1885,3,60,0
24,2,1864,1833,9,31,1
123,0,1879,1863,12,16,0
54,1,1895,1813,9,82,0
66,1,1812,1872,4,60,1
77,2,1906,1902,6,4,1
143,2,1873,1833,6,40,1
32,1,1916,1842,9,74,0
39,1,1854,1880,6,26,1
79,2,1839,1819,6,20,1
84,1,1795,1789,5,6,0
71,2,1717,1833,4,116,0
97,0,1761,1712,6,49,0
38,2,1770,1789,4,19,0
66,1,1890,1853,6,37,0
59,1,1800,1750,3,50,0
43,2,1500,1627,8,127,0
91,2,1822,1431,6,391,1
63,2,1416,1216,5,200,1
77,2,1393,1337,7,56,1
13,2,1867,1399,7,468,1
62,1,1438,1407,4,31,0
23,2,2009,1441,5,568,1
17,2,1460,1483,7,23,0
44,1,1500,1762,8,262,1
33,2,1937,1507,6,430,1
30,1,1508,2364,11,856,1
46,1,1319,1480,1,161,1
42,1,1486,2125,9,639,1
90,1,1734,1402,6,332,0
65,2,1915,1835,4,80,1
76,1,1853,1595,6,258,0
69,2,2340,1857,4,483,1
48,1,1798,1848,6,50,1
66,1,1850,2192,7,342,1
72,1,1862,1846,10,16,0
62,1,1788,1853,6,65,1
69,2,1846,1719,7,127,1
70,1,1551,1842,5,291,1
56,1,1852,1879,2,27,1
170,1,1819,1889,8,70,1
111,2,1880,1803,8,77,1
160,1,1935,1867,7,68,0
108,1,1879,1841,5,38,0
73,2,2231,1882,3,349,1
66,1,1850,1871,2,21,1
77,2,1870,1412,2,458,1
59,2,1949,1879,5,70,1
97,1,1324,1878,4,554,1
62,1,1889,1907,3,18,1
76,1,1708,1887,6,179,1
67,2,1841,1900,12,59,0
3,2,1375,1332,3,43,1
77,2,1318,1395,4,77,0
70,1,1331,1289,5,42,0
39,1,1254,1322,4,68,1
63,2,1309,1336,6,27,0
47,2,1326,1321,3,5,1
29,2,1308,1339,3,31,0
41,2,1285,1321,2,36,0
48,1,1270,1322,3,52,1
38,1,1327,1542,6,215,1
46,1,1328,1978,7,650,1
67,2,1550,1321,2,229,1
48,1,1322,1836,2,514,1
12,1,1328,1498,7,170,1
10,1,1358,1315,5,43,0
30,1,1319,1633,5,314,1
48,1,1330,1345,5,15,1
18,1,1343,1369,6,26,1
13,2,1335,1355,5,20,0
62,1,1140,1349,3,209,1
38,1,1350,1938,7,588,1
27,2,1360,1362,4,2,0
49,2,1783,1364,8,419,1
36,1,1368,1635,5,267,1
36,1,1370,1838,4,468,1
1,1,1464,1355,1,109,0
49,2,1341,1424,5,83,0
37,2,1819,1345,6,474,1
95,2,1324,1795,4,471,0
17,2,1318,1169,4,149,1
23,2,1743,1320,5,423,1
118,1,1329,1308,5,21,0
12,1,1317,1392,4,75,1
41,2,1309,1213,5,96,1
16,1,1321,1259,2,62,0
2,1,1336,1516,2,180,1
35,2,1375,1346,4,29,1
9,2,1398,1355,4,43,1
81,2,1346,1295,4,51,1
55,2,1351,1357,4,6,0
2,1,1039,1161,2,122,1
2,1,1055,1280,1,225,1
8,1,1086,1148,1,62,1
62,1,1091,1958,1,867,1
4,1,1091,1171,1,80,1
2,1,1091,1529,1,438,1
2,2,1091,1701,1,610,0
2,1,1091,1500,1,409,1
5,2,1674,1095,1,579,1
15,2,1907,1095,4,812,1
26,1,1185,1171,1,14,0
38,1,1193,1636,1,443,1
69,2,1733,1199,3,534,1
44,1,1236,1373,1,137,1
37,2,2047,1236,3,811,1
64,1,1264,1506,1,242,1
1,2,2032,1223,1,809,1
2,2,1765,1234,1,531,1
26,1,1246,1753,2,507,1
12,2,1739,1260,1,479,1
14,1,1279,1720,1,441,1
73,2,1694,1305,2,389,1
3,2,1654,1345,1,309,1
6,1,1423,1576,3,153,1
26,0,1662,1337,3,325,0
3,1,1500,1500,2,0,0
52,1,1500,1377,8,123,0
68,1,1377,1500,6,123,1
61,2,1500,1377,8,123,1
19,2,2126,1500,13,626,1
36,1,1500,2126,2,626,1
34,2,2126,1500,8,626,1
46,1,1500,2126,14,626,1
110,1,1500,2126,14,626,1
138,1,1537,1500,3,37,0
68,1,1500,1537,6,37,1
125,2,1500,1619,5,119,0
84,1,1026,1864,4,838,1
31,2,1513,1026,2,487,1
119,2,1519,1026,3,493,1
32,1,1026,1369,3,343,1
90,1,1026,1916,2,890,1
54,2,1145,1040,2,105,1
64,1,1043,1539,3,496,1
73,2,1878,1043,3,835,1
171,2,1666,1044,5,622,1
13,2,1856,1045,4,811,1
14,1,1382,1009,1,373,0
72,1,1547,971,3,576,0
52,1,971,1500,2,529,1
114,1,971,1629,2,658,1
21,1,981,1181,4,200,1
49,1,982,1700,3,718,1
81,2,1700,982,5,718,1
9,2,1735,982,3,753,1
61,1,982,1136,3,154,1
31,1,1371,1457,4,86,1
39,2,1883,1373,10,510,1
60,2,1344,1696,4,352,0
52,1,1348,1725,6,377,1
35,2,1863,1349,8,514,1
24,1,1460,1327,6,133,0
19,2,1338,1344,1,6,0
34,1,1359,1411,2,52,1
13,2,1829,1361,6,468,1
30,1,1365,1708,4,343,1
94,1,1366,2301,9,935,1
6,1,1254,1353,5,99,1
64,1,1369,1408,4,39,1
15,2,1344,1390,8,46,0
15,2,1512,1403,5,109,1
58,1,1405,2016,11,611,1
66,1,1412,1679,5,267,1
19,1,1479,1387,3,92,0
39,2,1889,1389,2,500,1
37,1,1392,1816,6,424,1
29,2,1817,1396,5,421,1
22,1,1760,1358,5,402,0
50,1,1360,1873,7,513,1
56,1,1383,1352,4,31,0
30,1,1536,1350,5,186,0
34,1,1356,1708,5,352,1
58,1,1376,1418,8,42,1
76,1,1333,1876,9,543,1
28,0,1313,1335,8,22,0
36,1,1349,1534,8,185,1
33,2,2086,1350,11,736,1
44,1,1370,1469,10,99,1
50,1,1406,1321,4,85,0
14,1,1410,1882,4,472,1
59,2,1241,1460,3,219,0
68,1,1370,1425,3,55,1
35,2,1384,1380,5,4,1
65,2,1435,1429,5,6,1
59,2,1469,1485,8,16,0
61,0,1494,1433,3,61,0
45,1,1555,1607,3,52,1
56,1,1437,1475,3,38,1
25,1,1346,1361,5,15,1
86,1,1393,1357,5,36,0
68,1,1368,1381,6,13,1
100,1,1375,1529,3,154,1
57,2,1590,1380,4,210,1
21,2,1371,1291,5,80,1
54,1,1135,1366,4,231,1
145,2,1741,1371,4,370,1
113,2,1363,1250,2,113,1
46,1,1347,1800,5,453,1
66,1,1349,1832,6,483,1
75,2,1343,1165,7,178,1
51,2,1326,1355,4,29,0
84,1,1354,1423,3,69,1
47,2,1635,1358,2,277,1
60,1,1540,1341,7,199,0
89,2,1329,1358,6,29,0
104,1,1331,1746,8,415,1
51,2,1321,1267,4,54,1
44,1,1334,1277,4,57,0
107,2,1324,1280,4,44,1
49,2,1368,1334,1,34,1
100,1,1340,1548,4,208,1
110,1,1348,1460,3,112,1
151,2,1335,1371,3,36,0
30,1,1345,1400,6,55,1
59,2,1341,1056,9,285,1
43,2,1376,1351,6,25,1
85,2,1337,1523,6,186,0
60,2,1313,1349,4,36,0
44,1,1359,1391,7,32,1
80,1,1216,1352,4,136,1
40,2,1160,1369,1,209,0
102,1,1374,1357,4,17,0
34,1,1369,1364,4,5,0
72,1,1373,1639,3,266,1
41,2,1468,1381,7,87,1
84,1,1385,1670,8,285,1
36,1,1392,1549,6,157,1
179,2,1303,1406,4,103,0
27,2,1398,1312,3,86,1
39,2,1297,1413,4,116,0
57,2,1400,1529,3,129,0
127,0,1398,1465,3,67,0
68,1,1403,1613,6,210,1
68,1,1408,1628,5,220,1
56,1,1419,1449,6,30,1
96,1,1432,1382,2,50,0
97,2,1444,1476,6,32,0
36,1,1476,1652,4,176,1
75,1,1492,1476,3,16,0
56,1,1479,1806,6,327,1
39,2,1740,1485,8,255,1
39,2,1581,1495,3,86,1
19,2,1597,1504,4,93,1
143,2,1684,1511,6,173,1
23,2,1579,1522,4,57,1
118,2,1502,1695,5,193,0
34,1,1507,1757,4,250,1
55,2,1605,1517,8,88,1
35,2,1748,1537,7,211,1
54,1,1547,1626,4,79,1
11,2,1353,1568,3,215,0
18,1,1589,1386,4,203,0
11,2,1369,1611,8,242,0
117,2,1721,1621,6,100,1
40,1,1635,1631,2,4,0
38,1,1533,1624,9,91,1
88,1,1633,1777,3,144,1
62,1,1649,1606,3,43,0
37,1,1646,1649,6,3,1
62,1,1500,1649,3,149,1
23,2,1307,1649,2,342,0
59,2,1649,1230,4,419,1
88,1,1673,1633,1,40,0
5,2,1821,1641,3,180,1
45,1,1649,1838,3,189,1
41,2,1466,1673,6,207,0
41,2,1742,1785,7,43,0
89,2,1650,1756,2,106,0
84,1,1629,1749,3,120,1
100,0,1519,1749,4,230,0
70,1,1851,1887,5,36,1
52,1,1874,1774,5,100,0
50,1,1891,1793,4,98,0
87,2,1876,1810,5,66,1
52,1,1745,1862,4,117,1
127,2,1833,1738,11,95,1
54,1,1637,1821,2,184,1
64,1,1587,1811,7,224,1
43,1,1861,1960,11,99,1
51,2,1882,1873,12,9,1
57,2,1946,1884,12,62,1
133,0,1885,1837,10,48,0
92,1,1796,1875,5,79,1
36,1,1884,2004,4,120,1
39,2,1863,1899,5,36,0
63,2,1581,1232,6,349,1
55,2,1581,1232,3,349,1
40,1,1232,1581,10,349,1
87,2,1232,1581,4,349,0
71,2,1500,1238,3,262,1
64,2,1188,1259,3,71,0
60,1,1515,1615,3,100,1
34,1,1615,1515,5,100,0
73,1,1277,1464,2,187,1
23,2,1371,1284,5,87,1
20,1,1500,1371,3,129,0
64,1,1372,1440,3,68,1
63,2,2131,1431,4,700,1
54,2,1426,1447,12,21,0
50,1,1485,1403,6,82,0
44,1,1401,1382,3,19,0
37,1,1392,1608,5,216,1
21,2,1603,1402,9,201,1
149,2,1402,1341,8,61,1
94,1,1116,1402,2,286,1
61,2,1116,1402,2,286,0
21,2,1116,1402,13,286,0
50,1,1116,1402,8,286,1
30,1,1402,1116,4,286,0
55,2,1402,1569,2,167,0
57,2,1737,1408,13,329,1
48,1,1431,1426,2,5,0
21,1,1455,1448,2,7,0
35,2,1859,1460,5,399,1
43,2,1501,1484,2,17,1
111,2,1457,1449,2,8,1
49,2,1419,1544,2,125,0
40,1,1419,1865,2,446,1
57,1,1433,1653,2,220,1
14,2,1781,1441,4,340,1
19,2,1639,1807,7,168,0
45,2,1807,1798,2,9,1
109,2,1889,1807,11,82,1
18,1,1807,1687,6,120,0
45,2,1639,1807,2,168,0
86,1,1630,1723,11,93,1
61,2,1555,1575,3,20,0
35,2,1555,1755,3,200,0
42,1,1881,1555,8,326,0
79,2,1555,1412,4,143,1
54,1,1412,1555,2,143,1
89,2,1293,2123,6,830,0
25,2,2118,1294,4,824,1
28,1,1295,2112,8,817,1
35,2,1500,2154,5,654,0
30,2,2075,2140,10,65,0
125,2,1848,2264,4,416,0
137,2,2056,2264,4,208,0
140,0,2264,1639,12,625,0
52,1,2366,2264,6,102,0
19,1,2030,2264,6,234,1
92,1,1778,2264,9,486,1
36,1,1778,2264,8,486,1
35,2,2264,1778,9,486,1
14,1,1778,2264,4,486,1
41,2,2264,1778,9,486,1
46,1,2016,2264,13,248,1
63,2,2264,2016,13,248,1
173,0,2225,2264,15,39,0
37,1,1305,2264,7,959,1
57,2,2264,1841,5,423,1
52,1,1841,2264,5,423,1
51,2,2264,1841,6,423,1
50,1,1841,2264,1,423,1
54,1,1855,2264,5,409,1
45,2,2264,1529,5,735,1
17,2,2264,1753,3,511,1
29,2,2264,1753,4,511,1
68,1,1753,2264,4,511,1
13,2,2264,1753,3,511,1
48,1,1753,2264,5,511,1
33,2,2264,1753,4,511,1
25,2,2264,1713,5,551,1
58,1,1455,2264,5,809,1
97,2,2264,1455,9,809,1
70,1,1455,2264,7,809,1
59,2,2264,1455,6,809,1
46,1,1455,2264,7,809,1
67,2,2264,1871,3,393,1
38,1,1871,2264,1,393,1
64,1,1615,2264,5,649,1
57,2,2264,1871,8,393,1
71,1,1871,2264,9,393,1
55,2,2264,1871,8,393,1
74,1,1885,2261,3,376,1
75,2,2249,2153,2,96,1
133,1,2188,2234,6,46,1
55,2,2218,2198,3,20,1
19,2,1466,1046,6,420,1
33,2,1457,1395,6,62,1
122,1,1349,1449,3,100,1
208,0,1465,1449,9,16,0
48,1,1316,1442,10,126,1
61,2,1434,1321,6,113,1
46,2,2026,1864,2,162,1
55,2,2021,1806,2,215,1
103,2,2016,2032,3,16,0
99,2,2024,1933,2,91,1
48,1,1892,2018,12,126,1
145,2,2008,1986,2,22,1
84,1,1830,2003,11,173,1
42,1,1985,1993,4,8,1
35,2,1980,2071,4,91,0
64,1,2064,1968,5,96,0
113,2,1958,1952,2,6,1
50,1,1720,1943,11,223,1
57,2,1937,1792,3,145,1
21,2,1930,1810,2,120,1
66,1,1950,1920,3,30,0
34,1,1802,1913,4,111,1
73,2,1903,1887,2,16,1
148,1,1901,1893,10,8,0
119,2,1829,1905,8,76,0
130,0,1903,1969,10,66,0
37,2,1954,1912,12,42,1
108,1,1927,1916,2,11,0
149,2,1874,1939,8,65,0
103,2,1899,1950,9,51,0
158,0,1952,1907,2,45,0
70,1,1957,2136,2,179,1
111,2,2007,1966,3,41,1
80,0,1970,1835,2,135,0
113,2,1989,1980,10,9,1
78,1,1810,1974,11,164,1
81,0,1973,2003,4,30,0
77,2,2069,1969,11,100,1
17,2,1958,1996,2,38,0
39,2,1951,1862,2,89,1
104,1,2066,1937,4,129,0
135,0,1869,1939,3,70,0
110,1,1948,1948,2,0,0
119,2,1937,1959,7,22,0
29,2,1950,1901,4,49,1
122,1,1726,1946,2,220,1
109,0,1941,1916,4,25,0
151,2,1859,1954,3,95,0
71,2,1975,1964,11,11,1
77,2,1956,1854,2,102,1
119,2,1785,1971,3,186,0
53,2,1960,2000,2,40,0
63,2,1949,1474,5,475,1
31,2,1474,1623,12,149,0
58,1,1702,1474,4,228,0
46,1,1474,2014,2,540,1
84,1,1500,1474,2,26,0
56,1,1363,1474,3,111,1
24,2,1390,1474,2,84,0
65,2,1474,1254,10,220,1
62,1,1495,1474,3,21,0
6,0,1500,1474,3,26,0
29,2,1820,1474,6,346,1
90,0,1474,2010,5,536,0
27,2,1474,1624,14,150,0
78,1,1767,1474,9,293,0
145,2,1474,1607,6,133,0
46,1,1487,1562,2,75,1
120,1,1254,1461,1,207,1
46,1,1514,1560,2,46,1
93,2,1572,1590,6,18,0
52,1,1503,1498,2,5,0
70,1,1629,1603,4,26,0
75,2,1500,1393,8,107,1
48,1,1873,2105,4,232,1
53,2,2065,1879,3,186,1
25,1,1886,2001,5,115,1
71,2,1797,2083,4,286,0
27,2,1500,1500,6,0,0
77,2,1128,795,2,333,1
130,1,1128,2177,2,1049,1
85,2,1114,1189,1,75,0
51,0,1191,1111,1,80,0
53,2,1111,921,4,190,1
36,1,897,1111,2,214,1
26,2,1111,897,1,214,1
52,2,1099,1124,2,25,0
139,2,1115,1013,1,102,1
72,1,1099,1115,2,16,1
142,1,1099,1115,2,16,1
60,1,1136,843,2,293,0
23,2,798,1157,2,359,0
9,2,2419,1157,5,1262,1
43,2,1151,964,1,187,1
34,1,1113,1581,3,468,1
38,2,1098,1202,6,104,0
23,2,1083,1218,5,135,0
6,1,1091,1203,3,112,1
37,2,1236,1098,7,138,1
19,2,1112,1109,3,3,1
21,2,1188,1118,3,70,1
65,0,1116,1173,2,57,0
28,1,1139,1104,5,35,0
19,2,1100,1116,6,16,0
47,2,1614,1711,2,97,0
30,1,1623,1701,7,78,1
100,1,1716,1659,5,57,0
71,0,1794,1714,11,80,0
29,2,1749,1726,4,23,1
43,2,1711,1760,7,49,0
35,2,1700,1625,7,75,1
32,2,1689,1593,10,96,1
85,2,1663,1705,2,42,0
112,1,1695,1691,8,4,0
34,2,1676,1684,2,8,0
38,1,1696,1659,2,37,0
25,2,1651,1466,5,185,1
15,2,1635,1647,2,12,0
41,2,1525,1657,2,132,0
49,2,1640,1650,8,10,0
68,2,1782,1651,2,131,1
51,2,1630,1697,7,67,0
50,1,1674,1655,4,19,0
45,2,1643,1696,4,53,0
92,1,1708,1864,7,156,1
70,1,1760,1683,3,77,0
86,1,1839,1651,5,188,0
54,1,1664,1820,5,156,1
45,2,1641,1645,6,4,0
42,1,1657,1614,7,43,0
25,2,1700,1635,2,65,1
45,2,1602,1671,4,69,0
70,1,1655,1566,6,89,0
136,1,1582,1770,8,188,1
40,1,1648,1591,4,57,0
44,0,1629,1586,4,43,0
58,1,1480,1551,7,71,1
52,1,1577,1763,6,186,1
74,1,1614,1732,5,118,1
63,2,1890,1639,9,251,1
88,0,1642,1638,2,4,0
85,2,1549,1551,6,2,0
65,2,1652,1674,2,22,0
81,2,1500,1497,5,3,1
68,1,1871,1774,9,97,0
56,1,1201,1871,2,670,1
75,2,1870,1202,2,668,1
14,1,1573,1866,4,293,1
68,1,1771,1857,2,86,1
24,1,1630,1851,7,221,1
21,2,1799,1866,4,67,0
18,1,1585,1861,3,276,1
43,2,1857,1590,5,267,1
41,1,1594,1852,4,258,1
16,1,1873,1574,7,299,0
57,0,1875,1821,8,54,0
75,2,1875,1074,5,801,1
48,1,1887,1892,5,5,1
41,2,1880,1781,3,99,1
54,1,1825,1869,3,44,1
93,2,1940,1879,4,61,1
64,0,1815,1882,1,67,0
57,2,1878,1534,2,344,1
22,2,1873,1630,7,243,1
73,2,1757,1891,4,134,0
53,2,1887,1564,5,323,1
60,1,1426,1885,2,459,1
95,2,1879,1671,8,208,1
89,2,1872,1708,8,164,1
58,1,1900,1900,16,0,0
74,1,1923,1211,9,712,0
73,2,1907,1677,6,230,1
42,1,1683,1901,4,218,1
55,1,1730,1893,3,163,1
45,2,1886,1737,2,149,1
47,2,1720,1905,3,185,0
27,2,1903,1454,4,449,1
67,2,1894,1775,5,119,1
55,2,1889,1641,5,248,1
29,2,1883,1646,9,237,1
50,1,1651,1878,4,227,1
50,1,1217,1259,2,42,1
52,1,1271,1517,2,246,1
28,1,1500,1406,3,94,0
8,1,1132,1258,1,126,1
22,1,1303,1248,2,55,0
84,1,1257,1296,3,39,1
25,2,1152,1271,5,119,0
68,1,1283,1255,3,28,0
82,1,1295,1226,3,69,0
8,1,1448,1280,3,168,0
151,2,1268,1312,2,44,0
81,2,1378,1276,4,102,1
34,1,1284,1370,3,86,1
60,1,1311,1272,3,39,0
47,2,1245,1284,6,39,0
100,0,1331,1296,2,35,0
40,1,1305,1360,3,55,1
110,1,1193,1298,5,105,1
57,2,1288,1257,4,31,1
51,2,1245,1300,5,55,0
70,1,1315,1189,2,126,0
19,2,1302,1377,2,75,0
65,2,1251,1314,4,63,0
45,2,1307,1180,3,127,1
37,2,1290,1548,4,258,0
37,2,1419,1309,5,110,1
59,2,1303,1321,5,18,0
30,1,1227,1312,2,85,1
63,2,1304,1226,2,78,1
45,2,1371,1315,3,56,1
128,1,1325,1361,3,36,1
40,1,1340,1316,3,24,0
31,2,1307,1246,3,61,1
97,2,1296,1298,3,2,0
7,2,1285,1279,2,6,1
15,2,1328,1295,5,33,1
58,1,1283,1499,4,216,1
9,2,1310,1304,6,6,1
14,1,1316,1298,7,18,0
43,2,1307,1272,3,35,1
53,2,1304,1318,3,14,0
46,1,1236,1309,4,73,1
91,2,1297,1319,8,22,0
49,2,1258,1299,4,41,0
53,2,1288,1268,3,20,1
17,2,1242,1291,3,49,0
17,2,1291,1242,3,49,1
22,1,1291,1500,2,209,1
46,1,1291,1318,2,27,1
59,2,1430,1434,4,4,0
43,2,1824,1500,2,324,1
25,1,1500,1332,4,168,0
55,2,1604,1344,5,260,1
61,2,1494,1364,5,130,1
8,2,1500,1364,4,136,1
38,1,1661,1364,3,297,0
16,2,1500,1364,6,136,1
98,1,1364,1525,3,161,1
79,2,1525,1364,4,161,1
68,2,1390,1364,1,26,1
17,2,1168,1364,1,196,0
55,2,1364,1500,6,136,0
47,2,1832,1500,1,332,1
47,2,2005,1500,5,505,1
74,1,1500,1531,4,31,1
71,2,1531,1500,2,31,1
12,1,1500,1500,8,0,0
52,1,1386,1468,3,82,1
26,2,1371,1398,6,27,0
66,1,1413,1271,3,142,0
42,1,1279,1406,2,127,1
135,2,1398,1286,3,112,1
27,1,1407,1461,4,54,1
53,2,1283,1422,2,139,0
29,2,2244,1411,5,833,1
54,1,1411,1411,6,0,0
69,2,1391,1411,4,20,0
28,1,1337,1391,6,54,1
87,2,1300,1405,3,105,0
26,1,1084,1402,8,318,1
43,2,1396,1231,4,165,1
50,1,1406,1416,4,10,1
49,2,1405,1417,4,12,0
128,1,1426,1481,6,55,1
54,2,1472,1436,6,36,1
49,2,1430,1256,2,174,1
55,2,1335,1444,2,109,0
59,2,1436,1345,2,91,1
76,1,1355,1428,2,73,1
41,1,1441,1338,3,103,0
56,1,1451,1480,3,29,1
82,1,1386,1442,6,56,1
75,2,1429,1511,3,82,0
131,2,1416,1491,3,75,0
38,1,1387,1406,6,19,1
69,1,1375,1396,4,21,1
48,1,1406,1423,2,17,1
80,1,1364,1397,2,33,1
35,2,1330,1409,3,79,0
81,2,1404,1197,3,207,1
49,2,1397,1415,3,18,0
79,2,1405,1408,3,3,0
13,2,1171,1422,3,251,0
105,2,1412,1401,2,11,1
83,2,1518,1419,1,99,1
46,1,1280,1413,6,133,1
77,2,1393,1527,2,134,0
51,2,1730,1393,4,337,1
55,2,1527,1393,3,134,1
78,1,1309,1393,4,84,1
51,2,1393,1309,5,84,1
78,1,1393,1527,3,134,1
56,1,1393,1309,4,84,0
134,1,1428,1279,4,149,0
63,2,1428,1730,3,302,0
61,2,1730,1428,4,302,1
50,1,1428,1527,3,99,1
87,2,1279,1428,4,149,0
65,2,1730,1428,2,302,1
73,2,1500,1428,3,72,1
25,2,1527,1309,1,218,1
137,0,1730,1309,6,421,0
56,1,1309,1730,3,421,1
107,2,1527,1309,4,218,1
78,1,1309,1393,4,84,1
169,0,1730,1309,4,421,0
51,2,1393,1309,5,84,1
108,1,1309,1527,4,218,1
56,1,1393,1309,4,84,0
37,2,1845,1507,1,338,1
70,1,1509,1868,3,359,1
16,1,1513,1783,2,270,1
60,1,1599,1499,2,100,0
61,2,1539,1510,2,29,1
72,1,1519,1557,3,38,1
120,1,1533,1507,1,26,0
24,1,1513,1695,1,182,1
54,1,1518,1716,5,198,1
155,2,1609,1526,7,83,1
80,1,1535,1620,2,85,1
59,2,1729,1553,3,176,1
50,1,1526,1542,2,16,1
53,2,1508,1555,6,47,0
27,2,1531,1579,8,48,0
43,2,1581,1541,6,40,1
52,1,1550,1620,9,70,1
82,1,1562,1556,6,6,0
53,2,2167,1562,5,605,1
60,1,1130,1383,6,253,1
50,1,1136,1383,1,247,1
37,2,1383,1136,6,247,1
76,1,984,1378,5,394,1
46,1,1378,1377,4,1,0
11,2,1372,1003,4,369,1
77,2,1364,1065,3,299,1
20,1,1196,1348,5,152,1
37,2,1336,1088,3,248,1
89,2,1310,1273,5,37,1
17,0,1382,1304,3,78,0
30,2,1285,1116,4,169,1
77,2,1271,1328,8,57,0
89,2,1574,1562,5,12,1
67,0,1590,1561,3,29,0
31,2,1558,1235,6,323,1
101,2,1547,1567,5,20,0
37,2,1517,1559,9,42,0
80,1,1429,1552,3,123,1
107,2,1741,1810,2,69,0
64,1,1805,1727,3,78,0
63,2,1866,1734,10,132,1
44,2,1722,1756,2,34,0
81,1,1740,1496,8,244,0
164,1,1750,1804,3,54,1
52,1,1757,1893,8,136,1
95,2,1746,1743,2,3,1
90,1,1534,1740,3,206,1
49,2,1498,1759,1,261,0
35,2,1672,1774,12,102,0
72,1,1932,1757,5,175,0
89,2,1742,1856,13,114,0
36,1,1500,1425,4,75,0
35,2,1425,1500,8,75,0
21,2,1417,1326,4,91,1
105,2,1403,1428,2,25,0
15,1,1437,1458,7,21,1
21,2,1446,1448,6,2,0
46,2,1441,1331,8,110,1
42,1,1470,1428,3,42,0
63,2,1415,1484,2,69,0
62,2,1402,1495,2,93,0
96,1,1345,1392,4,47,1
33,2,1420,1403,6,17,1
37,2,1556,1410,3,146,1
43,2,1507,1418,5,89,1
47,2,1410,1300,2,110,1
63,2,1398,1416,8,18,0
41,2,1383,1410,4,27,0
36,1,1428,1222,6,206,0
42,1,1436,1522,4,86,1
31,2,1428,1318,6,110,1
45,2,1500,1435,3,65,1
60,2,1593,1442,6,151,1
39,2,1469,1453,3,16,1
114,0,1450,1525,9,75,0
74,1,1461,1490,6,29,1
58,1,1400,1451,3,51,1
76,1,1525,1418,3,107,0
60,1,1427,1433,4,6,1
30,1,1464,1416,3,48,0
20,1,1476,1387,2,89,0
59,2,1378,1318,4,60,1
76,1,1299,1369,8,70,1
48,1,1384,1285,9,99,0
64,1,1500,1374,4,126,0
62,1,1333,1364,2,31,1
51,2,1350,1409,6,59,0
69,2,1327,1383,5,56,0
40,1,1337,1384,6,47,1
68,1,1033,1333,5,300,1
38,1,1500,1287,8,213,0
5,2,1465,1287,4,178,1
105,2,1413,1305,5,108,1
43,2,1275,1308,5,33,0
33,2,1245,1259,5,14,0
32,2,1292,1275,7,17,1
131,2,1264,1315,3,51,0
38,2,1282,1234,5,48,1
75,2,1250,1156,2,94,1
32,1,1250,1500,6,250,1
57,2,1138,1176,4,38,0
33,2,1373,1084,4,289,1
121,2,2286,1373,4,913,1
52,1,1194,1311,1,117,1
92,0,1330,1268,5,62,0
43,2,1511,1500,2,11,1
48,1,886,1659,7,773,1
41,2,1358,886,3,472,1
23,2,1620,890,2,730,1
49,2,1484,898,3,586,1
61,2,1500,898,4,602,1
19,2,1325,921,5,404,1
27,2,1397,940,7,457,1
31,2,1500,963,8,537,1
56,1,1049,1234,5,185,1
91,2,1118,1049,3,69,1
36,2,1110,1500,3,390,0
20,1,1500,1595,2,95,1
31,2,1359,1500,4,141,0
12,1,1500,1595,2,95,1
22,1,1500,1500,2,0,0
21,2,1649,1500,3,149,1
7,2,1500,1500,3,0,0
18,1,1500,1683,4,183,1
99,2,1804,2023,9,219,0
60,1,1822,1588,4,234,0
62,1,1853,1809,4,44,0
47,2,1805,1536,8,269,1
52,1,1580,1800,5,220,1
51,2,1794,1597,4,197,1
69,2,2100,1798,8,302,1
47,2,1789,1695,4,94,1
63,2,1774,1894,7,120,0
94,1,1719,1765,6,46,1
57,2,1874,1765,10,109,1
54,1,1781,1956,3,175,1
41,2,1773,1659,6,114,1
41,2,1899,1780,7,119,1
44,1,1714,1771,6,57,1
85,2,2032,1776,7,256,1
2,2,1765,1234,1,531,1
26,1,1246,1753,2,507,1
12,2,1739,1260,1,479,1
14,1,1279,1720,1,441,1
73,2,1694,1305,2,389,1
3,2,1654,1345,1,309,1
6,1,1423,1576,3,153,1
26,0,1662,1337,3,325,0
3,1,1500,1500,2,0,0
34,2,1579,1022,4,557,1
70,1,1028,1284,3,256,1
35,2,1307,1033,2,274,1
43,2,983,1051,2,68,0
42,1,1058,1249,2,191,1
11,1,1066,1256,5,190,1
20,1,1073,1313,4,240,1
65,2,1308,1079,5,229,1
39,2,1046,1096,3,50,0
112,1,1118,1002,2,116,0
61,2,1107,977,4,130,1
119,2,1125,1124,3,1,1
49,2,1328,1133,6,195,1
92,1,1150,1157,3,7,1
52,2,1131,1167,2,36,0
16,2,1107,1225,2,118,0
52,1,1129,1096,4,33,0
16,1,1132,1107,3,25,0
67,2,1208,1123,3,85,1
7,2,1099,1198,3,99,0
34,1,1110,1320,2,210,1
37,2,1315,1122,2,193,1
81,2,1094,1144,4,50,0
58,1,1317,1049,2,268,0
27,1,1061,1297,4,236,1
42,1,1074,1292,3,218,1
49,2,1287,1089,4,198,1
119,2,1098,1123,3,25,0
44,1,1138,1368,2,230,1
30,2,1114,998,2,116,1
47,1,1296,1051,4,245,0
95,2,1045,1101,3,56,0
16,1,1138,1217,4,79,1
49,2,1062,1216,6,154,0
3,2,1045,1080,3,35,0
67,2,1175,1121,5,54,1
64,1,1253,1232,7,21,0
86,1,1253,1956,2,703,1
36,1,1257,1715,2,458,1
41,2,1923,1258,5,665,1
38,1,1262,1661,5,399,1
70,1,1265,1720,2,455,1
39,2,1782,1268,3,514,1
25,2,1551,1276,5,275,1
23,2,1810,1278,5,532,1
19,1,1283,1668,3,385,1
43,2,2003,1284,5,719,1
109,2,1239,1699,3,460,0
45,2,1670,1243,6,427,1
46,1,1246,1759,8,513,1
40,1,1252,1611,3,359,1
31,2,1955,1253,10,702,1
32,1,1256,1703,6,447,1
45,2,1866,1258,9,608,1
96,1,1666,1212,4,454,0
52,1,1212,2215,6,1003,1
69,2,1928,1213,6,715,1
58,1,1178,1616,7,438,1
48,1,1268,1142,3,126,0
72,1,1017,1122,7,105,1
104,1,1152,1158,8,6,1
93,0,983,1167,5,184,0
55,1,1168,1833,3,665,1
38,1,1182,1429,3,247,1
68,1,1347,1417,8,70,1
65,2,1406,1371,4,35,1
32,1,1467,1390,8,77,0
99,2,1423,1402,6,21,1
83,2,1411,1431,7,20,0
52,1,1358,1420,5,62,1
17,2,1422,1500,4,78,0
72,1,1500,1422,2,78,0
23,2,1416,1330,6,86,1
50,1,1173,1410,3,237,1
39,2,1725,1402,2,323,1
104,1,1550,1372,8,178,0
35,2,1355,1352,2,3,1
125,0,1452,1351,9,101,0
80,1,1362,1458,6,96,1
56,1,1500,1362,3,138,0
6,1,1375,1435,1,60,1
77,2,1500,1375,2,125,1
14,2,1355,1431,2,76,0
49,2,1333,1471,3,138,0
101,2,1831,1520,5,311,1
39,2,1864,1520,6,344,1
47,2,1288,1520,6,232,0
24,1,1616,1504,6,112,0
122,1,1584,1504,4,80,0
58,1,1504,1612,4,108,1
68,1,1504,1737,5,233,1
66,1,1504,1500,4,4,0
58,1,1500,1504,3,4,1
51,2,1504,1500,3,4,1
38,1,1500,1504,3,4,1
61,2,1606,1504,5,102,1
74,1,1504,1606,5,102,1
56,1,1500,1504,3,4,1
81,2,1504,1500,2,4,1
54,1,1500,1504,3,4,1
41,2,1504,1500,4,4,1
62,1,1500,1504,2,4,1
42,1,943,1504,2,561,1
89,2,1504,1184,6,320,1
33,0,1428,1507,4,79,0
28,1,1233,1503,6,270,1
25,2,1500,1149,3,351,1
56,1,1587,1500,4,87,0
16,1,1500,1587,7,87,1
66,1,1587,1500,2,87,0
77,2,1500,1500,6,0,0
73,2,1500,1500,3,0,0
19,0,1527,1500,6,27,0
58,1,1500,1500,3,0,0
34,1,1500,1700,5,200,1
21,0,1500,1457,6,43,0
95,0,1500,1648,3,148,0
73,2,1712,1500,10,212,1
46,1,1500,1712,6,212,1
78,1,1500,1500,3,0,0
43,0,1788,1500,6,288,0
39,2,1500,1500,5,0,0
59,2,1500,1500,3,0,0
22,1,1500,1500,4,0,0
45,2,1500,1479,6,21,1
61,2,1381,1500,6,119,0
10,1,1500,1500,6,0,0
107,2,1702,1500,3,202,1
44,1,1665,1697,6,32,1
81,2,1668,1543,3,125,1
117,0,1659,1628,2,31,0
38,1,1680,1633,2,47,0
79,0,1680,1700,2,20,0
84,1,1696,1527,3,169,0
47,2,1693,1386,4,307,1
57,2,1687,1624,2,63,1
100,0,1691,1386,5,305,0
89,2,1684,1560,2,124,1
38,2,1672,1702,2,30,0
66,1,1579,1664,5,85,1
58,1,1678,1565,2,113,0
97,2,1680,1600,2,80,1
88,1,1691,1696,4,5,1
23,2,1684,1703,6,19,0
62,1,1717,1618,6,99,0
95,1,1626,1708,2,82,1
96,1,1722,1612,6,110,0
94,1,1730,1848,6,118,1
79,2,1724,1560,6,164,1
77,2,1519,1740,5,221,0
31,2,1738,1370,7,368,1
80,1,1656,1729,4,73,1
57,1,1628,1721,3,93,1
42,1,1728,1853,8,125,1
135,2,1719,1677,4,42,1
114,1,1687,1709,1,22,1
36,1,1721,1679,2,42,0
147,0,1696,1722,6,26,0
37,2,1718,1436,4,282,1
87,2,1709,1629,4,80,1
123,2,1704,1510,2,194,1
89,2,1695,1643,2,52,1
10,1,1518,1689,6,171,1
71,2,1683,1495,4,188,1
54,1,1694,1707,5,13,1
62,1,1744,1681,3,63,0
34,1,1482,1472,2,10,0
43,2,1473,1401,4,72,1
90,1,1221,1368,2,147,1
51,2,1481,1293,1,188,1
10,1,1500,1432,3,68,0
95,2,1403,1182,6,221,1
22,1,1365,1163,3,202,0
22,1,1163,1985,3,822,1
91,2,1153,1103,4,50,1
78,1,1158,1383,3,225,1
13,2,1147,1108,5,39,1
102,1,1206,1132,1,74,0
67,2,1103,1146,3,43,0
29,2,1127,1296,3,169,0
97,2,1111,1198,2,87,0
69,2,1172,1122,4,50,1
40,1,1136,1128,3,8,0
60,1,1160,796,4,364,0
144,1,795,1157,3,362,1
82,1,1084,1146,2,62,1
73,2,1146,995,5,151,1
62,1,1158,1191,3,33,1
115,2,1143,1191,5,48,0
67,2,1002,1163,4,161,0
62,2,1148,1165,2,17,0
60,1,1161,1200,3,39,1
57,2,1011,1184,3,173,0
48,1,1184,1070,1,114,0
22,1,1176,1070,2,106,0
42,1,1160,1070,2,90,0
99,2,1134,1023,3,111,1
100,0,1129,1248,3,119,0
72,1,1026,1116,4,90,1
90,1,1140,1011,2,129,0
33,2,995,1167,3,172,0
101,2,1156,997,2,159,1
80,1,1178,1132,2,46,0
54,1,1089,1162,3,73,1
72,1,1092,1144,2,52,1
38,1,1172,1077,2,95,0
62,1,1112,1151,3,39,1
7,2,1131,1071,4,60,1
50,1,1211,1500,6,289,1
43,2,1834,1218,4,616,1
43,2,1742,1218,3,524,1
17,2,1742,1218,2,524,1
113,2,1500,1261,2,239,1
18,1,1317,1538,2,221,1
46,1,1317,1500,3,183,1
23,2,1500,1317,5,183,1
39,2,1940,1327,3,613,1
63,2,1504,1500,2,4,1
3,2,1590,1388,1,202,1
26,1,1391,1774,6,383,1
69,2,1731,1395,6,336,1
117,2,1686,1400,7,286,1
48,1,1408,1577,6,169,1
32,1,1418,1741,4,323,1
81,2,2010,1419,7,591,1
61,2,1908,1421,8,487,1
40,1,1422,2026,5,604,1
29,1,1523,1375,7,148,0
93,1,1375,1992,4,617,1
95,2,1281,930,3,351,1
80,1,1221,1281,10,60,1
47,2,1278,946,3,332,1
18,1,950,1274,3,324,1
31,2,1270,953,5,317,1
61,2,1245,1277,4,32,0
93,2,1240,1012,2,228,1
114,1,1255,1157,7,98,0
46,1,874,1255,4,381,1
28,1,1152,1246,2,94,1
33,2,1242,953,10,289,1
107,2,1234,1087,4,147,1
9,2,1231,905,3,326,1
38,1,909,1227,4,318,1
105,2,1218,1111,6,107,1
32,1,1268,1204,3,64,0
115,2,1017,1223,4,206,0
123,2,1276,1234,3,42,1
72,1,1246,1238,3,8,0
29,2,1190,1261,4,71,0
105,2,1249,1233,4,16,1
41,2,1249,1500,4,251,0
49,1,1249,1531,2,282,1
105,2,1138,1266,2,128,0
35,2,1256,1163,2,93,1
43,2,1111,1275,4,164,0
97,2,1667,1250,5,417,1
40,1,1252,1770,3,518,1
57,2,1689,1254,4,435,1
56,1,1255,1833,4,578,1
35,2,2033,1256,1,777,1
46,1,1525,1232,5,293,0
60,1,1235,1592,2,357,1
31,2,1444,1242,7,202,1
60,1,1246,1565,3,319,1
52,1,1257,1342,4,85,1
19,2,1495,1263,3,232,1
41,2,1790,1265,4,525,1
36,1,1266,1854,3,588,1
54,1,1278,1329,7,51,1
42,1,1290,1436,1,146,1
30,1,1293,1710,4,417,1
70,1,958,1289,1,331,1
35,2,1709,1291,2,418,1
31,2,1755,1293,4,462,1
64,1,1296,1702,4,406,1
45,2,1680,1299,3,381,1
56,1,1302,1647,3,345,1
42,1,1303,1876,1,573,1
27,2,1473,1311,4,162,1
39,2,1774,1313,3,461,1
19,2,1302,1236,3,66,1
34,1,1313,1401,1,88,1
31,2,1809,1314,5,495,1
54,1,1323,1451,3,128,1
134,1,1369,1307,5,62,0
86,1,1319,1363,1,44,1
30,1,1324,1599,4,275,1
29,2,1698,1327,5,371,1
55,2,1552,1334,5,218,1
34,1,1289,1321,1,32,1
81,2,1297,1532,2,235,0
84,1,1300,1749,2,449,1
56,1,1302,1696,6,394,1
35,2,1282,1428,6,146,0
30,1,1453,1261,3,192,0
21,1,1235,1246,5,11,1
98,1,1453,1222,2,231,0
70,1,1338,1200,4,138,0
82,1,1208,1406,5,198,1
74,1,1213,1519,3,306,1
53,2,1833,1214,3,619,1
41,2,1185,1590,3,405,0
25,2,1848,1186,1,662,1
88,1,1188,1605,1,417,1
60,1,2035,1629,5,406,0
79,2,1609,1754,6,145,0
52,2,1584,1957,3,373,0
68,1,1374,1553,3,179,1
40,1,1813,1528,11,285,0
71,2,1503,1819,11,316,0
56,1,1669,1481,2,188,0
37,2,1467,1454,5,13,1
28,2,1429,1384,5,45,1
46,1,1453,1412,4,41,0
51,2,1385,1637,10,252,0
66,1,1235,1375,2,140,1
26,1,1431,1355,1,76,0
53,2,1763,1358,4,405,1
19,2,1306,1546,4,240,0
32,1,1248,1291,9,43,1
21,2,1258,1673,3,415,0
41,1,1916,1222,9,694,0
50,1,1788,1187,12,601,0
65,2,1155,1510,5,355,0
37,2,1132,1227,4,95,0
27,2,1113,1122,5,9,0
9,2,1102,930,4,172,1
59,2,1102,1810,1,708,0
22,1,1023,1086,3,63,1
106,1,1098,1249,1,151,1
79,2,1241,1112,2,129,1
124,1,1130,1210,1,80,1
60,1,1169,1104,3,65,0
88,1,1114,1384,1,270,1
39,2,1636,1116,3,520,1
53,2,1825,1074,2,751,1
28,1,1074,2151,1,1077,1
61,2,1429,1416,2,13,1
64,1,1425,1447,6,22,1
127,1,1451,1414,4,37,0
114,1,1424,1431,7,7,1
43,1,1436,1389,4,47,0
19,2,1426,1411,9,15,1
83,2,1419,1437,5,18,0
69,2,1399,1449,4,50,0
39,2,1441,1366,7,75,1
40,1,1453,1369,9,84,0
114,1,1464,1465,9,1,1
70,1,1476,1453,4,23,0
91,2,1497,1462,5,35,1
51,1,1472,1498,3,26,1
93,1,1459,1461,3,2,1
89,2,1456,1472,4,16,0
43,2,1462,1441,7,21,1
42,1,1450,1452,3,2,1
43,2,1441,1462,6,21,0
66,2,1451,1451,3,0,0
100,1,1461,1491,6,30,1
51,2,1465,1472,2,7,0
67,2,1462,1424,6,38,1
54,1,1450,1452,3,2,1
36,1,1464,1415,6,49,0
63,1,1417,1454,8,37,1
65,2,1443,1454,7,11,0
96,2,1471,1454,2,17,1
50,1,1465,1438,14,27,0
81,2,1417,1477,4,60,0
65,2,1474,1201,5,273,1
21,2,1510,1483,3,27,1
35,2,1480,1494,10,14,0
42,1,1498,1768,6,270,1
48,1,1510,1452,7,58,0
75,2,1435,1523,3,88,0
66,1,1536,1460,5,76,0
21,2,1514,1547,9,33,0
61,1,1559,1514,6,45,0
78,1,1568,1581,13,13,1
38,1,1475,1560,5,85,1
113,0,1561,1525,5,36,0
40,2,1553,1459,9,94,1
42,0,1456,1556,3,100,0
145,2,1546,1532,5,14,1
78,1,1543,1536,2,7,0
40,1,1547,1513,6,34,0
76,2,1477,1560,1,83,0
89,2,1551,1486,7,65,1
61,2,1472,1564,1,92,0
78,1,1436,1568,2,132,1
59,2,1567,1108,1,459,1
89,2,1301,1587,2,286,0
103,2,1292,1622,2,330,0
163,2,1616,1404,1,212,1
19,2,1613,1279,1,334,1
53,2,1607,1403,1,204,1
71,2,1600,1421,1,179,1
88,1,1580,1763,3,183,1
140,1,1711,1753,7,42,1
69,2,2211,1900,5,311,1
76,1,2070,2203,13,133,1
155,2,2196,2030,8,166,1
75,2,2290,2205,9,85,1
59,2,1962,2219,4,257,0
64,1,1966,2214,3,248,1
72,1,2232,2081,9,151,0
67,1,2169,2221,4,52,1
93,2,2209,2193,11,16,1
39,1,1788,2207,11,419,1
52,2,2202,1915,9,287,1
121,2,2199,1843,7,356,1
66,1,2178,2187,2,9,1
7,2,2173,2189,4,16,0
101,2,2167,1933,4,234,1
56,1,2080,2157,6,77,1
122,1,2176,2027,2,149,0
87,1,2018,2167,4,149,1
84,1,1989,2160,4,171,1
81,2,2147,2120,3,27,1
33,2,2145,1631,4,514,1
48,1,1692,2143,4,451,1
25,1,1690,2141,7,451,1
93,2,2129,2088,4,41,1
73,2,2022,2148,5,126,0
67,2,2146,1645,11,501,1
83,1,1739,2143,9,404,1
118,0,2155,1758,3,397,0
65,2,2148,1947,4,201,1
78,1,1852,1874,3,22,1
87,2,1828,1767,2,61,1
54,1,1863,1831,3,32,0
17,2,1846,1561,3,285,1
136,1,1565,1831,3,266,1
79,2,1814,1569,3,245,1
42,1,1741,1771,3,30,1
63,2,1712,1752,3,40,0
133,2,1832,1762,5,70,1
49,2,1921,1815,11,106,1
42,1,1581,1767,3,186,1
138,1,1410,1736,3,326,1
52,2,1688,1414,2,274,1
74,1,1852,1862,13,10,1
107,1,1868,1716,2,152,0
62,1,1881,1825,4,56,0
57,2,1854,1893,5,39,0
73,2,1885,1798,2,87,1
45,2,1864,2267,13,403,0
155,2,1832,1877,3,45,0
75,2,1859,1741,2,118,1
33,2,1913,1643,1,270,1
42,2,1732,1653,4,79,1
91,2,1645,1525,8,120,1
56,1,1663,1631,3,32,0
105,2,2063,1633,11,430,1
82,1,1445,1627,6,182,1
67,2,1625,1212,9,413,1
64,1,1634,1715,4,81,1
53,2,2054,1636,9,418,1
70,1,1638,2075,8,437,1
53,2,1617,2024,9,407,0
55,2,1727,1625,5,102,1
56,1,1638,1606,4,32,0
42,1,973,1173,1,200,1
43,2,1170,981,3,189,1
73,2,1272,986,1,286,1
78,1,999,1068,3,69,1
93,2,979,1043,2,64,0
41,2,906,1001,3,95,0
45,2,1053,1017,3,36,1
72,1,1037,1004,2,33,0
56,1,1059,1016,4,43,0
76,1,1036,1035,3,1,0
69,2,1261,1045,1,216,1
19,2,1351,1052,8,299,1
98,1,1071,1118,2,47,1
109,0,1064,1174,4,110,0
27,2,1378,1071,6,307,1
36,1,1092,1143,1,51,1
59,2,1140,1117,3,23,1
56,1,1141,1168,2,27,1
39,2,1221,1166,5,55,1
72,1,1296,1120,3,176,0
44,1,1136,1344,4,208,1
39,2,1076,1343,3,267,0
101,0,1004,1085,4,81,0
70,2,1023,1197,5,174,0
61,2,1190,1052,3,138,1
53,2,1110,1104,5,6,1
38,1,1152,1218,2,66,1
30,1,1221,1238,3,17,1
84,1,1135,1129,3,6,0
33,2,1218,1266,3,48,0
62,1,1500,1398,6,102,0
46,1,1500,1504,5,4,1
23,2,1644,1638,8,6,1
38,1,1638,2019,5,381,1
43,0,1500,1770,4,270,0
77,2,1480,1496,7,16,0
87,2,1480,1310,8,170,1
104,1,1082,1480,4,398,1
44,1,1480,1488,6,8,1
71,2,1359,1480,8,121,0
36,1,1350,1480,6,130,1
23,2,1480,1350,6,130,1
40,2,1357,1480,5,123,0
49,2,1480,1500,7,20,0
52,1,1500,1480,6,20,0
100,1,1444,1480,4,36,1
38,1,1480,1376,6,104,0
35,2,1480,1027,7,453,1
14,1,1027,1480,7,453,1
35,2,1480,1499,5,19,0
77,2,1480,1357,7,123,1
59,2,1480,1500,5,20,0
40,1,1225,1480,6,255,1
40,1,1480,1490,8,10,1
54,1,1316,1480,6,164,1
71,2,1082,1480,6,398,0
55,2,1480,1161,7,319,1
16,1,1500,1480,6,20,0
66,1,1314,1480,3,166,1
50,2,1225,1480,7,255,0
108,1,1480,1298,6,182,0
25,1,1480,1456,7,24,0
57,2,1480,1465,8,15,1
51,2,1480,1209,3,271,1
58,1,1209,1480,1,271,1
64,1,1500,1480,2,20,0
60,1,1500,1480,1,20,0
141,2,1480,1221,8,259,1
58,1,1480,1500,4,20,1
63,2,1480,1282,11,198,1
154,1,1276,1480,3,204,1
109,0,1475,1480,7,5,0
22,1,1301,1480,5,179,1
55,2,1480,1301,7,179,1
35,2,1500,1480,3,20,1
59,2,1480,1233,4,247,1
6,2,1480,1269,5,211,1
148,1,1498,1480,7,18,0
49,2,1480,944,7,536,1
16,1,1109,1171,7,62,1
29,2,1269,1136,4,133,1
78,1,1197,1078,1,119,0
25,2,1637,1205,1,432,1
59,2,1137,1324,2,187,0
55,2,1181,1200,4,19,0
15,2,1123,1256,1,133,0
75,2,1290,1179,4,111,1
5,2,1297,1346,3,49,0
46,1,1346,1354,2,8,1
35,2,1545,1500,5,45,1
39,2,1500,1409,2,91,1
28,1,1500,1725,1,225,1
63,2,1691,1500,5,191,1
51,2,1500,1500,3,0,0
26,1,1500,1542,3,42,1
35,2,1542,1500,2,42,1
10,1,1500,1827,3,327,1
58,1,1500,1348,3,152,0
52,1,1500,1331,3,169,0
84,1,1876,1906,5,30,1
79,2,1837,1900,4,63,0
40,1,1923,1887,6,36,0
64,1,1935,1875,5,60,0
66,1,1885,1897,9,12,1
141,2,1874,1876,2,2,0
68,1,1883,1961,5,78,1
59,2,1872,1895,2,23,0
56,1,1907,1860,3,47,0
41,2,1847,1921,6,74,0
68,1,1932,1951,3,19,1
92,1,1972,1919,4,53,0
126,1,1929,1955,3,26,1
56,1,1941,1925,9,16,0
102,1,1947,1929,5,18,0
114,1,1941,1925,6,16,0
36,1,1947,2114,8,167,1
3,0,1942,2119,3,177,0
112,1,1949,2104,9,155,1
99,1,1176,1704,6,528,1
54,1,1259,1704,3,445,1
74,1,1307,1704,5,397,1
25,2,1691,1704,9,13,0
73,2,1432,1704,1,272,0
25,2,1459,1704,7,245,0
21,2,1746,1704,5,42,1
40,1,1500,1521,1,21,1
153,2,2001,1740,3,261,1
126,1,1759,1532,4,227,0
62,1,1757,1895,6,138,1
45,2,1853,1766,5,87,1
92,1,1579,1760,4,181,1
143,0,1768,1824,4,56,0
68,0,1775,1544,3,231,0
71,2,1603,1559,1,44,1
45,2,1371,1576,4,205,0
62,1,1455,1568,4,113,1
62,1,1581,1535,3,46,0
38,1,1585,1820,6,235,1
23,2,1633,1595,8,38,1
68,1,1795,1578,5,217,0
16,2,1489,1592,3,103,0
52,1,1602,1636,4,34,1
67,2,1591,1581,6,10,1
105,2,1547,1604,4,57,0
39,2,1594,1554,4,40,1
29,2,1578,1787,7,209,0
51,2,1568,1549,12,19,1
148,0,1371,1573,4,202,0
23,2,1635,1583,6,52,1
111,2,1576,1437,5,139,1
51,2,1567,1494,6,73,1
62,1,1504,1558,7,54,1
38,1,1600,1545,6,55,0
83,2,1532,1614,5,82,0
26,1,1629,1517,4,112,0
49,1,1525,1633,6,108,1
74,1,1649,1510,2,139,0
60,1,1525,1385,7,140,0
118,1,1531,1689,5,158,1
94,1,1545,1461,6,84,0
118,1,1612,1531,6,81,0
52,1,1534,1868,6,334,1
116,1,1600,1521,2,79,0
35,2,1533,1532,7,1,1
99,2,1532,1472,3,60,1
47,2,1632,1541,6,91,1
170,1,1551,1574,6,23,1
99,2,1628,1560,9,68,1
101,2,1638,1570,4,68,1
64,1,1575,1772,5,197,1
87,2,1477,1590,4,113,0
118,0,1651,1608,4,43,0
121,2,1598,1539,6,59,1
131,2,1586,1607,8,21,0
79,2,1585,1045,4,540,1
35,2,1671,1594,7,77,1
30,2,1633,1604,3,29,1
21,1,1616,1600,6,16,0
65,2,1939,1619,4,320,1
102,1,1423,1614,2,191,1
78,1,1628,1538,7,90,0
41,2,1838,1610,5,228,1
82,2,2067,1843,3,224,1
55,2,1825,2109,11,284,0
71,2,2099,1829,4,270,1
108,1,1836,1987,11,151,1
113,2,1817,2085,5,268,0
43,2,1799,2073,8,274,0
100,1,1867,1785,8,82,0
97,2,1771,1875,2,104,0
36,1,1861,1757,4,104,0
26,2,1728,1769,3,41,0
40,1,1786,1609,6,177,0
98,1,1500,1782,3,282,1
32,2,1684,1785,5,101,0
59,2,1782,1484,4,298,1
29,2,1809,1792,5,17,1
34,1,1805,1757,2,48,0
35,2,1803,1335,4,468,1
69,2,1663,1826,5,163,0
41,2,1813,1874,5,61,0
127,2,1801,1854,2,53,0
45,1,1808,1947,5,139,1
46,1,1831,1796,5,35,0
19,2,1480,1815,8,335,0
83,2,1806,1728,11,78,1
65,2,1798,1885,8,87,0
86,0,1804,1869,5,65,0
97,2,1858,1814,3,44,1
105,0,1812,1874,4,62,0
51,2,1847,1822,8,25,1
53,2,1888,1831,3,57,1
64,1,1839,1967,11,128,1
76,1,1846,1977,5,131,1
76,1,1845,2011,14,166,1
33,2,1997,1852,3,145,1
139,0,1976,1848,6,128,0
65,2,1841,1847,3,6,0
25,2,1235,1669,6,434,0
67,2,1924,1674,6,250,1
96,1,1693,1455,4,238,0
62,2,1683,1619,11,64,1
102,1,1588,1674,6,86,1
63,2,1661,1680,4,19,0
46,1,1199,1659,6,460,1
100,2,1565,1673,10,108,0
134,1,1690,1540,5,150,0
72,1,1696,1896,11,200,1
81,2,1888,1702,8,186,1
87,2,1696,1515,8,181,1
56,2,1554,1713,4,159,0
160,1,1722,1817,9,95,1
60,2,1720,1334,2,386,1
119,2,1718,1205,5,513,1
18,1,1652,1708,5,56,1
109,1,1525,1494,5,31,0
84,1,1530,1561,3,31,1
76,1,1575,1516,10,59,0
65,2,1514,1108,5,406,1
27,2,1602,1523,5,79,1
13,1,1538,1452,5,86,0
66,1,1541,1900,7,359,1
79,2,1708,1548,2,160,1
76,1,1270,1544,5,274,1
70,1,1733,1732,4,1,0
105,2,1732,1733,2,1,0
5,2,1733,1732,2,1,1
8,1,1732,1733,2,1,1
60,1,1733,1732,5,1,0
54,1,1732,1733,15,1,1
53,2,1733,1732,4,1,1
55,2,1732,1654,8,78,1
64,1,1654,1732,6,78,1
146,1,1732,1733,5,1,1
113,0,1732,1733,7,1,0
102,1,1733,1732,12,1,0
15,2,1733,1732,4,1,1
33,2,1558,1551,4,7,1
119,2,1532,1546,2,14,0
50,1,1377,1520,2,143,1
66,1,1429,1487,4,58,1
45,2,1249,1500,1,251,0
36,1,1249,1500,11,251,1
31,2,1202,1238,4,36,0
51,2,1227,1254,5,27,0
29,2,1134,1259,5,125,0
11,2,1500,1134,2,366,1
77,2,1220,1205,5,15,1
42,1,1278,1357,3,79,1
16,1,1278,1711,4,433,1
58,1,1278,1500,2,222,1
41,2,1500,1278,2,222,1
16,1,1278,1500,2,222,1
18,2,1018,1278,7,260,0
10,1,1278,1500,3,222,1
6,1,1278,1500,3,222,1
7,2,1620,1278,3,342,1
74,1,1278,1500,6,222,1
53,2,1500,1278,4,222,1
79,2,1546,1278,5,268,1
70,1,1278,1611,3,333,1
47,2,1406,1278,6,128,1
41,2,1477,1364,3,113,1
21,2,1364,1283,6,81,1
87,2,1400,1259,2,141,1
57,2,1423,1400,2,23,1
60,1,1400,1476,2,76,1
72,1,1290,1400,1,110,1
73,2,1530,1400,2,130,1
27,2,1619,1400,2,219,1
44,1,1400,1619,3,219,1
72,1,1302,1400,2,98,1
113,2,1400,1475,3,75,0
46,2,1400,1476,2,76,0
16,2,1741,1400,2,341,1
73,2,1400,1028,2,372,1
106,0,1766,1400,2,366,0
51,2,1437,1400,2,37,1
18,1,1352,1400,2,48,1
95,2,1631,1400,5,231,1
18,2,1559,1400,2,159,1
64,1,1400,1635,2,235,1
9,2,1400,1381,3,19,1
25,1,1171,1400,2,229,1
59,2,1318,1400,2,82,0
85,2,1400,1372,2,28,1
30,1,1400,1387,3,13,0
15,2,1371,1400,2,29,0
66,1,1400,1349,3,51,0
38,1,1675,1400,2,275,0
18,1,1515,1400,2,115,0
81,2,1400,1332,2,68,1
58,1,1366,1400,2,34,1
31,1,1589,1400,2,189,0
49,2,1400,1466,3,66,0
44,1,1400,1437,2,37,1
65,2,1566,1400,1,166,1
40,1,1356,1400,2,44,1
28,1,1400,1395,2,5,0
56,1,1500,1400,2,100,0
19,2,1400,1396,2,4,1
105,2,1400,1412,2,12,0
40,1,1442,1400,1,42,0
50,1,1532,1503,4,29,0
40,1,1385,1526,7,141,1
90,1,1537,1509,8,28,0
42,1,1470,1528,6,58,1
15,2,1477,1541,6,64,0
48,1,1556,1420,4,136,0
15,2,1552,1314,3,238,1
57,2,1545,1393,4,152,1
50,1,1517,1535,3,18,1
44,1,1514,1524,3,10,1
52,1,1552,1512,5,40,0
40,1,1499,1501,2,2,1
27,2,1492,1456,5,36,1
95,2,1484,1378,6,106,1
138,1,1394,1475,6,81,1
23,1,1491,1283,5,208,0
48,1,1508,1243,4,265,0
128,1,1275,1504,1,229,1
16,1,1514,1515,5,1,1
34,1,1482,1504,5,22,1
131,0,1552,1491,3,61,0
28,1,1455,1480,6,25,1
31,2,1352,1496,3,144,0
46,1,1507,1494,3,13,0
35,2,1496,1489,4,7,1
52,1,1461,1486,11,25,1
23,2,1475,1465,3,10,1
111,2,2193,1882,10,311,1
19,2,2193,1963,5,230,1
40,1,1927,2193,10,266,1
13,2,2193,1965,6,228,1
4,1,1996,2193,2,197,1
36,1,1799,2193,10,394,1
53,2,2193,1799,8,394,1
46,1,1799,2193,3,394,1
135,2,2145,2193,7,48,0
24,1,1814,2193,7,379,1
57,2,2193,1864,6,329,1
19,2,2193,2002,10,191,1
62,1,2037,2157,8,120,1
51,2,2105,2047,3,58,1
33,2,2029,2040,7,11,0
47,2,1939,2177,7,238,0
31,2,2115,1945,6,170,1
38,1,1953,1973,7,20,1
27,2,1500,1906,8,406,0
52,1,1861,1500,6,361,0
127,2,1500,2119,9,619,0
138,1,2119,1500,10,619,0
28,1,1281,1500,1,219,1
43,2,1500,1281,6,219,1
80,1,1633,1625,11,8,0
21,2,1667,1634,9,33,1
49,2,1645,1645,5,0,0
60,1,1653,1742,3,89,1
45,2,1666,1663,8,3,1
112,1,1679,1652,3,27,0
171,2,1641,1643,3,2,0
65,2,1629,1699,3,70,0
114,1,1588,1619,11,31,1
75,2,2222,2126,12,96,1
114,1,2070,2126,8,56,1
68,1,1287,2126,1,839,1
3,2,1081,2126,3,1045,0
46,1,2126,1878,8,248,0
35,2,2126,1225,4,901,1
91,2,1659,2126,16,467,0
30,1,1911,2126,9,215,1
106,1,2009,2126,9,117,1
35,2,2126,1845,8,281,1
93,2,2126,1125,7,1001,1
40,2,2126,2047,9,79,1
48,1,2047,2126,9,79,1
51,2,2126,2202,6,76,0
32,1,1673,2126,10,453,1
29,1,1768,2126,4,358,1
62,1,2057,2126,10,69,1
24,1,2101,2048,10,53,0
80,1,1975,1962,7,13,0
33,2,1790,2034,6,244,0
51,2,1500,1319,5,181,1
71,2,1642,1055,2,587,1
9,2,1251,1086,2,165,1
31,1,1091,1645,1,554,1
43,2,1306,1124,2,182,1
54,1,1183,1248,1,65,1
69,2,1236,1285,2,49,0
83,2,1662,1315,2,347,1
51,2,1718,1345,4,373,1
41,2,1615,1500,2,115,1
96,1,1549,1425,5,124,0
60,1,1488,1478,6,10,0
90,1,1491,1541,1,50,1
98,1,1746,1466,6,280,0
67,2,1460,1242,4,218,1
23,2,1825,1463,7,362,1
21,2,1448,1461,4,13,0
61,2,1433,1421,1,12,1
92,1,1442,1609,1,167,1
16,1,1453,1558,1,105,1
67,2,1550,1466,5,84,1
79,2,1452,1378,1,74,1
67,2,1647,1461,6,186,1
45,2,1434,1665,4,231,0
61,2,1412,1477,1,65,0
94,2,1393,1404,4,11,0
65,2,1372,1409,4,37,0
83,2,1298,1398,6,100,0
133,2,1423,1418,6,5,1
67,1,1311,1402,4,91,1
47,2,1383,1323,1,60,1
46,1,1333,1361,5,28,1
64,1,1522,1404,7,118,0
74,1,1537,1453,8,84,0
47,2,1433,1553,10,120,0
123,2,1544,1444,5,100,1
39,2,1657,1544,5,113,1
114,1,1853,1523,5,330,0
53,2,1491,1537,9,46,0
27,2,1525,1501,3,24,1
27,2,1504,1811,4,307,0
61,2,1493,1439,3,54,1
123,2,1685,1499,3,186,1
99,2,1862,1502,4,360,1
17,2,1496,1316,7,180,1
101,2,1908,1498,6,410,1
54,1,1500,1989,10,489,1
45,2,1482,1648,6,166,0
32,1,1500,1473,5,27,0
113,2,1566,1494,7,72,1
44,1,1497,1820,2,323,1
23,2,1480,1637,6,157,0
47,2,1675,1486,4,189,1
54,2,1474,1460,1,14,1
53,2,1492,1487,3,5,1
43,2,1540,1569,4,29,0
10,1,1570,2090,7,520,1
85,1,1574,1853,9,279,1
56,1,1587,1573,2,14,0
29,2,1576,1587,5,11,0
48,1,1299,1583,3,284,1
56,1,1507,1573,5,66,1
88,1,1574,2093,3,519,1
84,1,1576,2023,6,447,1
83,2,1560,1661,3,101,0
76,1,1253,1556,1,303,1
75,2,1538,1721,7,183,0
43,2,1354,1557,4,203,0
66,1,1183,1554,1,371,1
48,2,1548,1334,2,214,1
22,1,1304,1543,5,239,1
36,1,1558,1479,6,79,0
42,1,1572,1544,4,28,0
96,1,1555,1632,9,77,1
64,1,1563,1697,6,134,1
65,2,1563,1411,6,152,1
69,2,1421,1347,4,74,1
25,2,1563,1352,2,211,1
51,2,1336,1468,8,132,0
99,2,1525,1343,7,182,1
60,1,1349,1497,5,148,1
69,2,1468,1358,4,110,1
44,1,1360,1764,7,404,1
99,2,1344,1478,8,134,0
132,1,1474,1328,3,146,0
69,2,1615,1332,4,283,1
12,1,1338,1541,9,203,1
64,1,1345,1483,4,138,1
48,1,1351,1532,5,181,1
36,1,1360,1432,10,72,1
28,1,1445,1345,4,100,0
30,1,1353,1485,3,132,1
46,1,1342,1546,7,204,1
25,2,1696,1344,3,352,1
92,1,1348,1652,7,304,1
90,1,1356,1461,4,105,1
111,2,1596,1360,4,236,1
45,2,1525,1367,4,158,1
50,0,1362,1529,8,167,0
56,0,1534,1357,7,177,0
46,2,1497,1364,1,133,1
12,1,1372,1461,2,89,1
56,1,1375,1679,3,304,1
47,2,1454,1384,4,70,1
30,1,1392,1488,5,96,1
53,2,1479,1400,3,79,1
138,1,1341,1391,5,50,1
30,1,1399,1483,6,84,1
61,2,1564,1399,1,165,1
68,1,1440,1387,4,53,0
81,2,1381,1181,2,200,1
119,2,1651,1385,3,266,1
18,1,1347,1376,6,29,1
30,1,1376,1444,3,68,1
89,2,1383,1386,3,3,0
35,2,1489,1394,1,95,1
11,2,1429,1404,3,25,1
22,1,1431,1376,2,55,0
43,2,2005,2151,4,146,0
59,2,2285,2173,2,112,1
41,2,1500,1370,3,130,1
58,1,1370,1500,8,130,1
16,2,1514,1378,3,136,1
48,1,1311,1368,3,57,1
88,1,1369,2070,4,701,1
61,2,1344,1961,7,617,0
70,1,1880,1320,4,560,0
12,1,1807,1274,3,533,0
45,2,1253,1620,6,367,0
68,1,1632,1232,5,400,0
62,1,1232,2017,8,785,1
41,1,1359,1218,5,141,0
39,2,1210,1112,2,98,1
35,2,1210,1191,4,19,1
106,1,1221,1226,3,5,1
29,1,1157,1211,3,54,1
19,2,1201,1180,5,21,1
18,1,1207,1190,8,17,0
19,2,1179,1197,7,18,0
138,1,1315,1163,7,152,0
61,1,1166,1061,2,105,0
25,2,1197,1176,6,21,1
47,2,1163,1214,4,51,0
32,1,1152,1152,3,0,0
60,1,1156,1442,4,286,1
118,1,1154,1332,2,178,1
51,2,1348,1160,5,188,1
27,2,1322,1147,3,175,1
14,1,1153,1370,3,217,1
123,0,1152,1162,4,10,0
74,1,1064,1144,1,80,1
8,1,1144,1500,3,356,1
125,2,1192,1153,4,39,1
122,1,1106,1143,6,37,1
120,1,1157,1092,3,65,0
123,2,1076,1171,4,95,0
56,1,1083,1165,4,82,1
35,0,1189,1164,4,25,0
55,2,1151,1202,2,51,0
59,1,1236,1137,2,99,0
85,2,1301,1143,2,158,1
78,1,1148,1417,5,269,1
67,1,1155,1292,2,137,1
74,1,1660,1838,4,178,1
85,2,1751,1838,6,87,0
64,2,1961,1838,11,123,1
39,2,1848,1838,8,10,1
157,2,1838,1699,9,139,1
56,1,1977,1919,6,58,0
51,2,1868,1991,9,123,0
21,2,1835,1760,11,75,1
44,1,1769,1791,9,22,1
42,1,1473,1775,1,302,1
31,2,1755,1477,6,278,1
20,1,1481,1730,1,249,1
35,2,1697,1486,3,211,1
50,1,1492,1649,1,157,1
59,2,1603,1384,7,219,1
25,2,1500,1524,2,24,0
31,2,1492,1173,5,319,1
15,2,1356,1186,6,170,1
74,1,1208,1311,5,103,1
45,2,1513,1197,5,316,1
13,2,1175,1142,3,33,1
52,1,1175,1673,3,498,1
27,2,1673,1175,7,498,1
9,2,1175,1673,3,498,0
130,0,1462,1158,6,304,0
11,2,1473,1166,3,307,1
44,1,1155,1170,3,15,1
56,2,1137,1190,2,53,0
22,1,1234,1096,1,138,0
68,1,1097,1902,2,805,1
25,2,1901,1097,6,804,1
29,2,1500,1097,6,403,1
25,1,1097,1500,4,403,1
62,1,1101,1635,3,534,1
13,2,1633,1104,3,529,1
16,1,1107,1631,3,524,1
49,2,1273,1129,1,144,1
94,1,1155,1265,2,110,1
22,1,1158,1766,3,608,1
8,0,1517,1134,6,383,0
16,0,1551,1703,4,152,0
71,2,1703,1551,5,152,1
69,1,1703,1677,4,26,0
27,2,1677,1703,10,26,0
47,2,1703,1677,5,26,1
44,2,1703,1583,3,120,1
46,2,1682,1703,2,21,0
111,2,1579,1722,4,143,0
33,2,1722,1745,6,23,0
57,2,1722,1767,11,45,0
41,2,1767,1722,8,45,1
99,1,1722,1735,4,13,1
89,2,1722,1674,13,48,1
76,1,1674,1722,6,48,1
96,0,1727,1586,5,141,0
43,2,1727,1621,12,106,1
44,2,1856,1727,6,129,1
63,2,1670,1744,4,74,0
54,1,1744,1924,4,180,1
54,2,1897,1744,3,153,1
21,2,1732,1759,3,27,0
43,2,1747,1703,4,44,1
75,0,1749,1702,7,47,0
28,1,1749,1806,2,57,1
39,2,1738,1623,4,115,1
28,1,1632,1727,3,95,1
57,2,1857,1737,5,120,1
112,0,1776,1736,5,40,0
109,2,1715,1788,4,73,0
153,2,1798,1729,5,69,1
11,2,1714,1658,4,56,1
45,2,2076,1714,3,362,1
32,1,1714,1709,4,5,0
20,1,1800,1714,3,86,0
28,1,1714,1800,4,86,1
52,1,1800,1714,4,86,0
61,2,1651,1737,3,86,0
17,2,1737,1647,8,90,1
62,1,1647,1737,3,90,1
31,2,1737,1647,7,90,1
32,1,1737,1631,6,106,0
29,2,1868,1737,7,131,1
85,2,1549,1419,6,130,1
15,2,1772,1554,2,218,1
40,1,1559,1767,6,208,1
59,2,1664,1568,4,96,1
36,1,1578,1603,9,25,1
25,2,1835,1582,7,253,1
72,1,1593,1608,10,15,1
64,1,1620,1581,4,39,0
85,2,1567,1632,2,65,0
48,1,1646,1553,3,93,0
89,2,1538,1660,6,122,0
51,2,1859,1541,4,318,1
37,2,1370,1558,3,188,0
56,1,1565,1712,4,147,1
39,1,1571,1725,6,154,1
59,2,1748,1571,10,177,1
122,1,1575,1844,4,269,1
82,2,1840,1580,6,260,1
44,1,1698,1564,7,134,0
41,2,1557,1443,8,114,1
18,1,1452,1549,2,97,1
113,2,1666,1556,4,110,1
59,2,1575,1567,13,8,1
37,2,1701,1575,3,126,1
101,2,1570,1321,5,249,1
81,2,1556,1676,6,120,0
70,1,1597,1543,7,54,0
15,2,1529,1610,5,81,0
71,2,1623,1538,4,85,1
32,2,1752,1543,5,209,1
44,1,1549,1720,4,171,1
39,1,1557,1675,6,118,1
63,2,1663,1565,3,98,1
59,2,1644,1574,3,70,1
87,0,1573,1599,2,26,0
16,1,1611,1560,7,51,0
52,1,1548,1549,4,1,1
55,1,1555,1730,10,175,1
26,1,1559,1839,1,280,1
36,1,1570,1578,8,8,1
50,1,1640,1556,4,84,0
26,1,1600,1542,4,58,0
17,2,1728,1549,4,179,1
42,2,1643,1558,4,85,1
119,2,1822,1562,2,260,1
64,1,1569,1710,3,141,1
94,1,1579,1557,11,22,0
46,1,1706,1540,4,166,0
24,1,1543,1858,4,315,1
101,2,1805,1548,4,257,1
88,1,1500,1769,3,269,1
78,1,1413,1500,7,87,1
31,2,1500,1500,4,0,0
2,2,1500,1784,2,284,0
72,2,1706,1500,7,206,1
70,1,1347,1500,5,153,1
30,1,1644,1810,4,166,1
87,2,939,963,4,24,0
66,2,1458,939,2,519,1
59,2,1449,940,4,509,1
80,1,949,1064,4,115,1
66,1,961,974,1,13,1
89,2,963,975,3,12,0
5,2,1046,986,3,60,1
52,1,1500,1482,1,18,0
46,2,1306,1275,2,31,1
35,2,1259,1319,4,60,0
40,1,1272,1169,2,103,0
8,1,1278,1500,2,222,1
53,2,1265,1500,4,235,0
120,1,1265,1500,4,235,1
73,1,1265,1500,4,235,1
22,0,1264,1268,4,4,0
66,1,1278,1280,4,2,1
85,2,1282,1293,5,11,0
30,1,1500,1279,3,221,0
49,2,1271,1096,7,175,1
70,1,964,1267,3,303,1
19,0,1270,1179,3,91,0
80,1,1277,1490,5,213,1
5,2,1370,1422,4,52,0
41,2,1370,1176,3,194,1
53,2,1366,1402,2,36,0
30,1,1442,1310,1,132,0
153,1,1495,1283,3,212,0
86,0,1387,1507,4,120,0
2,1,1264,1507,2,243,1
81,2,1554,1546,2,8,1
56,1,1586,1632,3,46,1
42,1,2103,2198,2,95,1
35,2,2188,2173,2,15,1
132,1,2066,2180,5,114,1
42,0,2180,2186,4,6,0
178,1,2190,2234,5,44,1
130,1,2201,2173,4,28,0
91,2,2104,2215,17,111,0
56,1,2226,2219,5,7,0
61,2,2330,2234,10,96,1
67,2,2121,2234,17,113,0
79,2,2218,1953,5,265,1
190,1,2151,2209,5,58,1
116,1,2221,2209,5,12,0
79,2,2194,2232,11,38,0
35,2,2221,2222,2,1,0
59,2,2230,1666,8,564,1
83,2,2276,2230,4,46,1
74,1,2230,2201,5,29,0
65,2,2226,1977,5,249,1
67,2,2218,2133,2,85,1
114,1,2225,2207,5,18,0
51,2,2199,2112,5,87,1
100,0,2199,2179,5,20,0
76,1,2179,2189,4,10,1
132,1,1502,1530,5,28,1
29,1,1368,1496,4,128,1
115,2,1488,1437,3,51,1
109,2,1470,1499,5,29,0
86,1,1513,1384,5,129,0
57,2,1514,1523,6,9,0
64,1,1534,1528,6,6,0
89,2,1523,1538,3,15,0
122,1,1550,1511,4,39,0
20,1,810,1218,4,408,1
33,2,1209,831,3,378,1
38,1,1210,2026,3,816,1
96,1,1211,2025,6,814,1
137,2,1586,1236,4,350,1
44,1,1255,1815,2,560,1
81,2,1179,1610,4,431,0
22,1,1188,1716,6,528,1
11,2,1718,1215,3,503,1
17,2,1733,1226,4,507,1
35,2,1483,1275,3,208,1
43,2,1378,1430,6,52,0
14,1,1387,1621,10,234,1
12,1,1421,1278,3,143,0
143,2,1391,1448,5,57,0
52,1,1461,1357,6,104,0
14,1,1476,1316,6,160,0
13,2,1180,1358,7,178,0
30,1,1394,1358,5,36,0
61,2,1638,1408,5,230,1
52,1,1439,1493,4,54,1
15,2,1483,1478,5,5,1
44,2,1447,1581,3,134,0
47,2,1498,1677,7,179,0
34,1,1561,1574,3,13,1
42,1,1500,1507,5,7,1
86,1,1624,1504,4,120,0
33,2,1430,1492,3,62,0
74,1,1524,1269,3,255,0
23,1,1500,1401,2,99,0
87,2,1500,1508,2,8,0
32,1,1508,1500,6,8,0
16,1,1508,2016,1,508,1
59,2,1508,1500,4,8,1
24,1,1508,1727,7,219,1
67,2,1500,1508,4,8,0
93,2,1508,1403,2,105,1
104,1,1500,1581,3,81,1
102,1,1238,1500,2,262,1
10,1,1500,1693,3,193,1
37,2,1693,1500,3,193,1
60,1,1500,1693,3,193,1
20,1,1622,1500,4,122,0
13,2,1160,1323,2,163,0
6,1,1418,1588,1,170,1
43,2,1930,1500,2,430,1
2,1,1761,1579,2,182,0
79,2,1745,1853,6,108,0
98,1,1750,1733,8,17,0
31,2,1733,1624,3,109,1
101,2,2108,1736,5,372,1
40,2,2105,1738,8,367,1
46,2,2101,1741,9,360,1
24,2,1852,1748,7,104,1
60,1,1759,1500,9,259,0
51,2,1749,1716,7,33,1
112,1,1763,1661,13,102,0
77,2,1809,1700,2,109,1
42,1,1801,1686,5,115,0
65,2,1711,1713,8,2,0
137,0,1712,1751,5,39,0
52,1,1764,1711,5,53,0
85,2,1737,1745,6,8,0
35,2,1734,1748,5,14,0
80,1,1696,1725,4,29,1
105,2,1712,1770,5,58,0
90,1,1734,1701,3,33,0
149,2,1796,1709,2,87,1
96,1,1720,1697,7,23,0
38,1,1704,1852,3,148,1
84,1,1718,1587,4,131,0
41,2,1779,1727,5,52,1
62,1,1737,1775,6,38,1
53,2,1888,1744,6,144,1
27,2,1852,1761,6,91,1
78,1,1772,1770,5,2,0
47,2,1799,1782,6,17,1
33,2,1820,1792,5,28,1
103,2,1734,1805,6,71,0
46,1,1696,1797,6,101,1
79,1,1695,1789,3,94,1
73,2,1780,1722,4,58,1
37,2,1914,1780,10,134,1
23,2,1786,1966,4,180,0
41,2,1882,1806,1,76,1
29,2,1792,1898,2,106,0
50,1,1760,1782,3,22,1
85,2,1818,1793,2,25,1
29,2,1785,2054,5,269,0
39,2,1215,1511,3,296,0
39,2,1687,1218,3,469,1
35,2,1316,1237,4,79,1
32,1,1261,1279,3,18,1
21,2,1228,1292,3,64,0
13,2,1255,1151,2,104,1
79,2,1391,1161,7,230,1
43,2,1142,1066,1,76,1
40,1,1162,1242,1,80,1
78,2,1204,1187,2,17,1
29,2,1229,1215,2,14,1
12,1,1336,1190,2,146,0
47,2,1150,1223,1,73,0
40,2,1450,1150,2,300,1
85,2,1425,1164,4,261,1
46,1,1452,1108,4,344,0
65,2,1255,1108,2,147,1
17,0,1108,1255,3,147,0
73,0,1255,1108,10,147,0
91,2,1255,1108,1,147,1
88,0,1108,1255,3,147,0
64,1,1255,1108,10,147,0
90,1,1142,1431,4,289,1
57,2,1107,1022,5,85,1
32,1,1107,1352,3,245,1
45,2,1581,1513,2,68,1
69,2,1505,1393,2,112,1
25,2,1493,1517,3,24,0
50,1,1494,1506,2,12,1
75,2,1497,1494,2,3,1
90,1,1572,1484,4,88,0
14,1,1492,1563,5,71,1
37,2,1511,1502,4,9,1
52,1,1513,1527,4,14,1
52,1,1478,1503,4,25,1
54,1,1513,1541,2,28,1
22,1,1322,1507,3,185,1
31,2,1504,1509,3,5,0
85,2,1502,1500,3,2,1
64,2,1491,1505,2,14,0
9,2,1512,1490,3,22,1
40,1,1502,1469,2,33,0
132,1,1497,1491,3,6,0
42,1,1430,1482,3,52,1
50,2,1465,1493,6,28,0
37,2,1476,1432,2,44,1
117,2,1501,1486,3,15,1
70,1,1531,1473,1,58,0
14,1,1483,1521,5,38,1
59,2,1491,1493,3,2,0
39,2,1480,1592,2,112,0
26,1,1479,1514,2,35,1
58,1,1468,1468,9,0,0
104,1,1479,1462,2,17,0
63,2,1624,1486,9,138,1
97,2,1476,1469,2,7,1
51,2,1467,1404,2,63,1
63,1,1479,1427,6,52,0
33,2,1489,1478,3,11,1
79,2,1467,1468,6,1,0
33,2,1578,1475,9,103,1
11,2,1466,1395,2,71,1
21,2,1532,1475,4,57,1
17,2,1462,1545,2,83,0
26,2,1536,1471,3,65,1
29,2,1457,1550,2,93,0
61,2,1422,1469,2,47,0
39,1,1481,1436,3,45,0
59,2,1477,1492,3,15,0
27,2,1500,1407,2,93,1
34,1,1407,1500,1,93,1
17,2,1500,1407,2,93,1
5,2,1937,1407,1,530,1
47,2,2141,1414,3,727,1
18,1,1500,1742,2,242,1
9,2,1342,1221,7,121,1
44,1,1254,1204,8,50,0
53,2,1184,1269,7,85,0
26,1,1203,1140,4,63,0
7,2,1329,1215,3,114,1
4,2,1325,1227,4,98,1
45,2,1500,1227,2,273,1
17,1,1233,1532,3,299,1
57,2,1567,1238,6,329,1
85,2,1681,1216,5,465,1
171,2,1189,1373,4,184,0
28,2,1162,1319,3,157,0
78,1,1446,1133,5,313,0
1,2,2404,1616,1,788,1
91,2,1616,1657,2,41,0
70,1,1499,1449,5,50,0
48,1,1405,1365,3,40,0
7,2,1302,1351,3,49,0
30,1,989,1658,8,669,1
52,1,989,1658,3,669,1
2,1,1610,989,2,621,0
3,2,989,1610,2,621,0
3,2,1538,991,3,547,1
20,1,1003,1246,3,243,1
7,2,958,1274,3,316,0
41,2,1500,963,1,537,1
36,1,963,1500,3,537,1
62,1,978,1179,8,201,1
71,2,1172,996,3,176,1
44,1,1032,1011,1,21,0
33,2,1142,1061,1,81,1
29,2,1424,1061,4,363,1
64,0,1691,1451,3,240,0
89,2,1471,1461,3,10,1
57,1,1440,1451,3,11,1
113,0,1450,1468,3,18,0
34,1,1455,1679,8,224,1
99,0,1454,1489,5,35,0
32,1,1508,1440,3,68,0
33,2,1425,1576,5,151,0
103,0,1580,1420,4,160,0
111,0,1418,1480,2,62,0
18,1,1545,1402,2,143,0
67,2,1392,1332,11,60,1
81,2,1382,1388,8,6,0
57,2,1347,1395,3,48,0
99,2,1395,1367,5,28,1
102,1,1418,1472,4,54,1
40,1,1423,1645,3,222,1
38,2,1500,1423,1,77,1
20,1,1457,1418,6,39,0
112,1,1421,1754,7,333,1
91,2,1464,1432,4,32,1
37,2,1363,1447,1,84,0
115,2,1653,1453,1,200,1
47,2,1710,1460,5,250,1
46,1,1465,1706,7,241,1
31,2,1701,1470,4,231,1
53,2,1554,1479,1,75,1
20,1,1488,1591,8,103,1
167,2,1579,1497,6,82,1
63,2,1482,1537,2,55,0
70,1,1528,1468,7,60,0
77,0,1467,1501,4,34,0
41,0,1559,1472,5,87,0
112,1,1549,1456,2,93,0
68,1,1436,1434,1,2,0
59,2,1858,1436,8,422,1
96,0,1431,1585,8,154,0
80,1,1443,1471,5,28,1
67,2,1661,1132,4,529,1
36,1,1073,1135,1,62,1
91,2,1551,1142,3,409,1
16,1,1155,1483,5,328,1
24,2,1780,1157,5,623,1
8,1,1157,2312,3,1155,1
18,1,1164,1616,3,452,1
103,2,1563,1173,4,390,1
10,2,1805,1176,2,629,1
76,1,1209,1320,3,111,1
106,1,1215,1703,4,488,1
26,1,1515,1127,4,388,0
13,2,1002,1534,3,532,0
54,1,1009,1513,3,504,1
67,2,1511,1017,3,494,1
12,1,1027,1509,3,482,1
57,2,1264,1064,3,200,1
60,1,1072,1625,1,553,1
16,1,1073,1939,3,866,1
39,2,1793,1076,5,717,1
9,2,1374,1115,4,259,1
38,2,1539,1136,5,403,1
34,1,1149,1677,1,528,1
41,2,1535,1182,3,353,1
26,1,1500,1182,2,318,0
57,2,856,1541,1,685,0
52,1,1435,2042,5,607,1
31,2,1828,1500,7,328,1
12,1,1353,1207,5,146,0
35,2,1347,1013,2,334,1
73,2,1334,1183,1,151,1
86,1,1079,1325,2,246,1
11,2,1314,1099,3,215,1
2,1,1052,1304,2,252,1
10,1,1100,1393,5,293,1
81,2,1393,1100,5,293,1
15,1,1100,1393,3,293,1
12,1,1027,1084,4,57,1
55,2,1065,1073,5,8,0
81,2,1085,1082,3,3,1
50,1,1104,1057,5,47,0
46,1,1130,1019,4,111,0
21,2,1125,1153,2,28,0
27,2,1152,1159,3,7,0
2,2,1112,1283,2,171,0
54,1,1141,1098,3,43,0
35,2,1080,1177,2,97,0
23,2,1152,1206,1,54,0
20,1,1145,1174,2,29,1
10,1,1205,1199,4,6,0
12,0,1216,1093,4,123,0
4,1,1141,1175,2,34,1
44,1,1018,1142,2,124,1
22,1,1208,1140,6,68,0
86,1,1195,1123,4,72,0
50,1,1221,1168,5,53,0
108,1,1054,1384,4,330,1
41,2,1703,1484,5,219,1
16,2,1455,1427,5,28,1
21,2,1433,1306,11,127,1
30,1,1469,1476,4,7,1
109,2,1785,1481,3,304,1
54,1,1315,1455,7,140,1
96,1,1466,1815,10,349,1
255,0,1585,1448,3,137,0
68,0,1907,1448,7,459,0
39,0,1291,1451,7,160,0
104,1,1278,1406,4,128,1
54,1,1515,1404,5,111,0
75,2,1473,1221,10,252,1
67,2,1610,1599,3,11,1
68,1,1907,1599,7,308,0
88,1,1299,1500,7,201,1
54,1,1430,1500,3,70,1
56,1,1576,1500,3,76,0
39,2,1901,1500,3,401,1
121,2,1093,1119,4,26,0
44,1,1117,898,6,219,0
27,2,1169,1133,5,36,1
35,2,1106,1273,6,167,0
45,2,1251,1119,8,132,1
20,1,1128,1347,4,219,1
78,1,1146,1355,5,209,1
56,1,1254,1116,4,138,0
141,2,1228,1133,3,95,1
61,2,1705,1135,5,570,1
64,1,1158,1306,3,148,1
19,2,1759,1163,5,596,1
26,1,1167,1627,6,460,1
51,2,2023,1168,2,855,1
115,2,1426,1178,5,248,1
100,1,1200,1252,17,52,1
75,2,1427,1213,7,214,1
64,1,1303,1175,10,128,0
14,0,1155,1424,6,269,0
36,1,1155,1907,15,752,1
85,0,1170,1302,18,132,0
64,1,1173,1718,4,545,1
77,2,1278,1204,10,74,1
75,2,1473,1221,10,252,1
74,1,1264,1288,17,24,1
70,1,1907,1264,2,643,0
38,0,1420,1239,5,181,0
40,1,1277,1409,6,132,1
31,2,1804,1284,5,520,1
56,1,1406,1404,3,2,0
47,2,1231,1516,4,285,0
33,2,1466,1303,7,163,1
32,1,1500,1458,4,42,0
23,2,1127,1234,4,107,0
77,2,1242,1162,2,80,1
17,2,1104,1168,7,64,0
128,1,1138,1276,3,138,1
32,1,1186,1283,5,97,1
48,1,1256,1301,5,45,1
26,2,1102,1301,2,199,0
46,1,1205,1279,4,74,1
12,2,1311,1205,3,106,1
32,1,1500,1311,4,189,0
124,1,1676,2003,5,327,1
17,2,2001,1571,7,430,1
94,1,1629,2001,2,372,1
23,2,1582,1079,5,503,1
51,2,1582,1079,9,503,1
38,1,1079,1582,4,503,1
85,2,1582,1410,1,172,1
114,1,1410,1582,2,172,1
70,1,1500,1582,2,82,1
85,2,1582,1500,5,82,1
62,1,1500,1582,3,82,1
53,2,1582,1500,6,82,1
60,1,1143,1591,2,448,1
41,2,1591,1143,7,448,1
20,1,1143,1591,4,448,1
14,1,1143,1591,3,448,1
51,2,1591,1143,6,448,1
39,2,1591,1143,5,448,1
70,1,924,1097,4,173,1
9,2,918,996,5,78,0
15,2,1146,1048,4,98,1
80,1,1077,1359,4,282,1
39,2,1196,1162,8,34,1
66,1,1362,1157,2,205,0
81,2,989,1362,7,373,0
69,2,1033,1362,2,329,0
28,1,1362,1500,2,138,1
46,1,1500,1584,4,84,1
113,0,1847,1541,3,306,0
46,1,1555,1844,7,289,1
114,1,1856,1819,4,37,0
59,2,1681,1874,2,193,0
93,2,1868,1663,7,205,1
68,1,1741,1860,11,119,1
84,1,1881,1518,6,363,0
71,1,1573,1877,3,304,1
61,2,1871,1704,9,167,1
93,2,1858,1920,7,62,0
49,2,1846,1834,2,12,1
40,1,1836,1832,3,4,0
168,1,1841,1914,6,73,1
61,2,1826,1965,4,139,0
28,1,1626,1820,2,194,1
53,2,1818,1368,9,450,1
61,2,1901,1827,3,74,1
83,2,1791,1803,3,12,0
71,2,1792,1788,7,4,1
77,2,1780,1808,5,28,0
97,0,1456,1789,3,333,0
156,1,1802,1740,6,62,0
69,2,2031,1807,4,224,1
77,2,2182,1809,5,373,1
65,2,2062,1814,2,248,1
76,1,1828,1697,3,131,0
29,2,1821,1699,9,122,1
66,1,1915,1807,2,108,0
91,2,1791,1929,5,138,0
73,2,1922,1799,1,123,1
62,1,1810,1817,4,7,1
105,1,1822,1798,1,24,0
75,2,1784,1871,2,87,0
98,1,1788,2059,4,271,1
72,1,1461,1785,3,324,1
62,1,1094,1047,6,47,0
54,1,1104,1280,4,176,1
66,2,1633,1106,2,527,1
37,2,1506,1109,1,397,1
29,1,1109,1227,3,118,1
55,2,1709,1117,3,592,1
48,0,1302,1116,1,186,0
73,2,1084,1370,4,286,0
39,2,1732,1085,3,647,1
49,2,2022,1085,4,937,1
48,1,1086,1774,8,688,1
79,2,1651,1087,6,564,1
9,2,1319,1096,1,223,1
51,2,1683,1097,4,586,1
33,2,1080,1047,2,33,1
94,1,1092,1247,3,155,1
47,2,1707,1093,5,614,1
27,2,1425,1099,4,326,1
11,1,1121,1105,3,16,0
70,1,1121,1501,3,380,1
60,1,1126,1483,3,357,1
27,2,1778,1126,3,652,1
50,0,1186,1126,1,60,0
73,2,1476,1131,5,345,1
21,2,1884,1131,5,753,1
39,2,1494,1137,3,357,1
45,2,2335,2262,6,73,1
110,1,2271,2322,9,51,1
45,2,2307,2280,5,27,1
40,1,2291,2290,9,1,0
77,2,2269,2347,5,78,0
47,2,2247,2323,2,76,0
45,2,2235,2118,12,117,1
40,1,2126,2221,8,95,1
41,2,2202,2234,9,32,0
48,1,2193,2181,2,12,0
62,1,2204,2157,10,47,0
46,1,2120,2135,6,15,1
31,2,2135,1151,6,984,1
38,1,1151,2135,1,984,1
34,1,1586,2133,7,547,1
22,1,1635,2131,3,496,1
92,1,1967,2116,11,149,1
65,2,2080,2278,10,198,0
53,2,2070,1821,5,249,1
22,1,1791,2060,6,269,1
68,1,2043,2032,8,11,0
57,2,2016,1839,5,177,1
52,2,1989,1945,5,44,1
49,2,1943,2091,13,148,0
51,2,1909,1887,10,22,1
20,1,1729,1886,7,157,1
137,2,1627,1627,4,0,0
46,1,1657,1638,4,19,0
39,2,1970,1666,5,304,1
76,1,1696,1629,2,67,0
126,1,1669,1792,2,123,1
66,1,1714,1676,4,38,0
106,0,1744,1440,5,304,0
112,1,1573,1715,4,142,1
46,1,1472,1691,2,219,1
134,1,1787,1533,4,254,0
80,1,1550,1755,3,205,1
47,0,1757,1748,10,9,0
88,1,1840,1606,2,234,0
45,1,1589,1444,2,145,0
76,1,1545,1684,6,139,1
43,2,1500,1081,6,419,1
43,2,2422,2324,11,98,1
64,1,2458,2424,17,34,0
39,2,2415,2331,12,84,1
50,1,2420,2404,9,16,0
150,1,2513,2383,2,130,0
96,1,2469,2369,8,100,0
136,0,2220,2374,13,154,0
71,2,2367,2234,12,133,1
86,1,2249,2359,12,110,1
55,1,2324,2349,4,25,1
28,1,2226,2342,7,116,1
83,2,2331,2336,7,5,0
117,2,2203,2346,10,143,0
95,2,2338,2272,12,66,1
98,1,2347,2394,2,47,1
120,1,2355,2449,7,94,1
107,2,1817,1798,7,19,1
154,1,1645,1737,4,92,1
48,1,1641,1726,3,85,1
38,1,1726,1653,5,73,0
16,2,1592,1500,3,92,1
44,1,1587,1519,6,68,0
36,1,1547,1801,6,254,1
59,2,1678,1618,4,60,1
20,1,1674,1862,10,188,1
3,2,1430,2173,3,743,0
54,0,1430,1618,6,188,0
42,1,1500,1810,6,310,1
21,2,1257,1042,2,215,1
46,2,971,1153,5,182,0
23,2,1214,994,4,220,1
55,2,1748,996,4,752,1
63,2,1127,1193,2,66,0
90,1,1193,1319,4,126,1
24,1,1244,1394,3,150,1
91,2,1386,1352,3,34,1
33,2,1559,1500,5,59,1
77,2,2131,2103,10,28,1
91,2,2095,1991,2,104,1
125,2,2088,1974,2,114,1
41,2,2247,2094,6,153,1
118,1,1453,1380,5,73,0
49,2,1446,1317,7,129,1
64,1,1459,1392,4,67,0
42,1,1434,1449,11,15,1
35,2,2621,1449,9,1172,1
67,2,1816,1409,11,407,1
63,2,1757,1500,11,257,1
71,2,1757,1500,10,257,1
26,1,1500,1901,4,401,1
19,2,1500,1161,2,339,1
1,2,1500,2723,1,1223,0
42,1,1500,1937,4,437,1
32,1,1500,2021,28,521,1
24,1,1500,1477,3,23,0
53,2,1500,1442,2,58,1
89,2,1500,1849,7,349,0
43,2,1500,1710,2,210,0
85,2,1500,2047,4,547,0
76,0,1500,1989,4,489,0
51,2,1500,2117,2,617,0
139,0,1500,1500,11,0,0
78,2,1500,1535,4,35,0
75,2,1500,2080,16,580,0
89,2,1500,2054,4,554,0
94,0,1500,2081,14,581,0
72,0,2070,1500,11,570,0
72,1,1916,1500,13,416,0
34,1,1500,1500,13,0,0
134,0,1656,1500,12,156,0
64,1,1557,1500,4,57,0
28,2,1500,1615,2,115,0
80,2,1500,1679,2,179,0
53,2,1500,2122,2,622,0
45,2,1500,1259,2,241,1
70,2,1500,2003,2,503,0
47,2,1500,1758,2,258,0
59,2,1500,1960,2,460,0
67,2,1500,1869,6,369,0
124,2,1500,2445,9,945,0
73,2,1826,1851,6,25,0
110,1,1854,1814,3,40,0
156,0,1813,1834,3,21,0
62,1,1828,1801,5,27,0
21,2,1900,1810,3,90,1
64,1,1819,1891,2,72,1
35,2,1882,1828,3,54,1
75,2,1813,1940,5,127,0
23,2,2035,1818,4,217,1
55,2,1912,1827,3,85,1
9,2,1227,1204,5,23,1
38,2,1253,1236,2,17,1
100,1,1245,1294,4,49,1
60,1,1234,1235,2,1,1
57,2,1254,1245,4,9,1
137,2,1277,1255,5,22,1
132,1,1265,1267,4,2,1
58,1,1275,1286,2,11,1
102,2,1256,1286,4,30,0
22,1,1298,1244,2,54,0
67,2,1231,1311,2,80,0
60,1,1291,1301,2,10,1
55,2,1290,1290,5,0,0
112,1,1300,1319,3,19,1
53,2,1345,1310,8,35,1
58,2,1330,1320,5,10,1
11,2,1309,1314,5,5,0
101,2,1298,1369,5,71,0
39,2,1306,1307,3,1,0
28,1,1318,1318,2,0,0
89,2,1378,1326,4,52,1
101,1,1336,1355,3,19,1
45,2,1365,1345,4,20,1
76,1,1356,1355,2,1,0
136,1,1315,1346,4,31,1
81,2,1388,1356,6,32,1
63,2,1335,1333,7,2,1
37,2,1325,1262,3,63,1
61,2,1316,1282,6,34,1
137,0,1312,1316,4,4,0
86,1,1277,1306,5,29,1
17,1,1244,1297,6,53,1
45,2,1288,1254,2,34,1
96,1,1346,1276,2,70,0
37,2,2013,1773,5,240,1
57,2,2105,1806,6,299,1
46,1,1836,1741,7,95,0
128,1,1858,1903,4,45,1
14,1,1793,2131,9,338,1
23,2,1754,2131,3,377,0
46,1,1596,2131,6,535,1
77,1,1236,2131,5,895,1
73,2,2135,1980,14,155,1
71,2,1540,2025,3,485,0
51,2,1709,1703,1,6,1
29,2,1707,1542,3,165,1
70,1,1127,1707,6,580,1
107,2,1699,1366,2,333,1
59,2,1679,1517,3,162,1
89,2,1645,1411,6,234,1
50,1,1416,1625,6,209,1
88,1,1500,1625,4,125,1
43,2,1625,1500,3,125,1
23,2,1618,1136,2,482,1
63,2,1618,1500,3,118,1
96,1,1688,1485,7,203,0
58,1,1344,1648,3,304,1
85,2,1639,1203,2,436,1
61,2,1379,1746,3,367,0
65,2,1697,1606,3,91,1
58,1,1763,1816,3,53,1
83,2,1621,1475,3,146,1
45,2,1500,1371,3,129,1
10,2,1657,1033,1,624,1
60,1,1033,1500,2,467,1
10,1,1035,1603,1,568,1
56,1,1036,1653,2,617,1
77,2,1652,1038,3,614,1
81,2,1359,1044,3,315,1
36,1,1051,1356,1,305,1
18,0,1051,1257,2,206,0
39,2,1257,1051,3,206,1
29,0,1051,1257,2,206,0
11,2,1598,1053,2,545,1
50,1,1062,1322,2,260,1
50,1,1025,1579,2,554,1
23,2,1331,1025,3,306,1
6,0,1025,1734,1,709,0
59,2,1470,1029,4,441,1
10,1,1035,1401,2,366,1
41,2,1470,1039,3,431,1
9,1,1041,1600,3,559,1
4,1,1156,1005,3,151,0
20,1,1006,1679,1,673,1
6,0,1414,983,3,431,0
35,2,1256,937,2,319,1
18,1,946,1250,3,304,1
87,2,1418,1264,2,154,1
63,2,1621,1268,5,353,1
51,2,1330,1272,4,58,1
66,1,1277,1550,2,273,1
157,2,1546,1282,3,264,1
35,2,1259,1472,7,213,0
71,2,1467,1267,3,200,1
113,2,1573,1271,3,302,1
9,2,1569,1276,3,293,1
26,1,1279,1696,3,417,1
33,2,1340,1293,3,47,1
50,1,1294,1804,9,510,1
39,2,1802,1296,4,506,1
30,1,1298,1800,8,502,1
39,2,1861,1299,4,562,1
89,2,1268,1316,6,48,0
23,2,1347,1331,4,16,1
65,2,1418,1331,2,87,1
67,1,1340,1511,6,171,1
18,2,1325,1500,1,175,0
53,2,1455,1336,2,119,1
51,2,1609,1866,4,257,0
47,2,1760,1866,11,106,0
30,2,1866,1729,5,137,1
49,1,1563,1866,11,303,1
2,2,1866,1500,2,366,1
3,1,1500,1866,3,366,1
39,2,1866,1510,6,356,1
38,1,1866,1466,5,400,0
94,1,1407,1866,4,459,1
94,1,1614,1866,1,252,1
9,2,1866,1556,5,310,1
30,1,1500,1866,3,366,1
19,2,1866,1500,4,366,1
13,2,1866,1438,6,428,1
33,2,1500,1866,2,366,0
81,2,1866,1500,5,366,1
28,1,1500,1866,4,366,1
56,1,1706,1866,5,160,1
69,2,1866,2236,5,370,0
86,1,1817,1866,4,49,1
31,2,1866,1514,9,352,1
55,2,2326,1907,4,419,1
20,1,1907,1770,4,137,0
26,1,1922,1839,2,83,0
101,0,1836,1925,4,89,0
17,2,1925,1457,2,468,1
40,1,1457,1925,2,468,1
67,2,2160,1925,7,235,1
17,0,2160,1925,5,235,0
127,0,1986,1925,5,61,0
102,1,1925,1777,2,148,0
78,1,1777,1925,4,148,1
48,1,1932,2075,4,143,1
24,1,1319,1932,3,613,1
92,1,1800,1932,8,132,1
68,1,1941,2034,3,93,1
38,1,1950,2049,8,99,1
53,2,1810,1967,5,157,0
141,2,1967,1567,4,400,1
43,2,1967,1411,3,556,1
50,1,1422,1967,5,545,1
71,2,1959,1839,6,120,1
26,1,1896,1959,8,63,1
52,1,1959,1629,6,330,0
150,1,1972,1959,2,13,0
20,1,1970,1959,5,11,0
26,1,1955,1946,5,9,0
87,2,1929,2046,3,117,0
77,2,1916,1922,5,6,0
50,1,1505,1914,1,409,1
21,2,1834,1930,4,96,0
57,2,1846,1947,5,101,0
47,2,1939,1778,5,161,1
105,0,1938,1980,4,42,0
85,2,1919,1994,3,75,0
97,0,1996,1916,5,80,0
62,1,1928,1988,2,60,1
36,1,1023,1821,5,798,1
28,1,1030,1501,2,471,1
43,2,1422,1040,4,382,1
63,1,1043,1701,2,658,1
22,1,1049,1539,3,490,1
57,1,1055,1569,6,514,1
67,2,1500,1500,2,0,0
51,2,1500,1500,10,0,0
94,1,1500,1500,6,0,0
35,2,1500,1500,7,0,0
62,1,1500,1500,6,0,0
11,2,1500,1500,9,0,0
57,2,1500,2263,5,763,0
146,1,2263,1500,9,763,0
79,2,1500,2263,2,763,0
98,0,2263,1500,8,763,0
23,2,2349,1750,1,599,1
46,1,1750,1437,4,313,0
14,2,1895,1750,7,145,1
29,0,1975,1750,10,225,0
9,2,1570,1750,2,180,0
58,1,1910,1714,10,196,0
54,1,1695,1688,5,7,0
27,2,1661,1666,6,5,0
53,1,1516,1643,7,127,1
42,1,1737,1601,8,136,0
25,2,1552,1754,4,202,0
28,1,1773,1495,9,278,0
131,2,1575,1527,7,48,1
30,2,1512,1254,3,258,1
35,1,1259,1494,5,235,1
16,1,1509,1439,7,70,0
42,1,1626,1353,2,273,0
46,1,1603,1353,10,250,0
3,2,1848,1873,3,25,0
39,1,1873,1884,2,11,1
35,1,1873,1744,5,129,0
33,1,1873,2008,2,135,1
119,2,1873,1851,6,22,1
37,2,1873,1541,6,332,1
53,2,1873,1500,3,373,1
42,1,1500,1873,7,373,1
95,2,1873,1525,3,348,1
81,2,1873,1525,4,348,1
22,2,1525,1873,7,348,0
140,0,1542,1537,3,5,0
142,1,1521,1526,5,5,1
39,2,1518,1410,7,108,1
48,1,1626,1503,4,123,0
96,1,1519,1547,6,28,1
112,1,1521,1892,3,371,1
86,1,1229,1517,9,288,1
71,2,1502,1635,3,133,0
71,2,1913,1504,5,409,1
94,1,1351,1498,3,147,1
61,2,1491,1525,9,34,0
35,2,1504,1509,4,5,0
68,1,1521,1484,5,37,0
55,2,1569,1542,4,27,1
147,2,1651,1550,2,101,1
104,1,1551,1538,9,13,0
2,1,1633,1287,2,346,0
33,2,1434,1724,4,290,0
35,2,1651,1740,3,89,0
29,2,1580,1590,5,10,0
85,2,1561,1163,6,398,1
26,1,1716,1422,5,294,0
24,2,1681,1388,4,293,1
47,2,1636,1364,4,272,1
41,1,1291,1500,5,209,1
15,2,1417,1213,5,204,1
98,1,1013,1206,3,193,1
54,1,1216,1344,4,128,1
43,2,1194,1356,4,162,0
11,2,1315,1205,2,110,1
78,1,1192,1487,1,295,1
13,2,1451,1198,3,253,1
63,2,1171,1408,3,237,0
9,2,1455,1177,5,278,1
99,1,1295,1153,3,142,0
65,2,1307,1518,4,211,0
48,1,1240,1297,7,57,1
71,2,1290,1144,4,146,1
38,1,1574,1260,1,314,0
47,2,1556,1264,9,292,1
38,1,1267,1552,4,285,1
60,1,1279,1629,4,350,1
97,2,1626,1282,5,344,1
48,1,1285,1623,7,338,1
36,1,1644,1264,6,380,0
94,1,1267,1641,8,374,1
136,1,1271,1549,7,278,1
60,1,1526,1253,7,273,0
44,1,1335,1241,3,94,0
44,1,1250,1243,7,7,0
150,1,1248,1239,7,9,0
96,1,1201,1230,6,29,1
30,1,1217,1219,2,2,1
34,1,1231,1205,4,26,0
56,1,1240,1219,5,21,0
75,2,1226,1230,5,4,0
52,2,1250,1244,6,6,1
21,2,1200,1257,3,57,0
65,2,1175,1270,7,95,0
53,2,1262,1184,3,78,1
49,2,1169,1276,3,107,0
40,1,1283,1393,6,110,1
37,2,1385,1291,3,94,1
42,1,1299,1376,1,77,1
31,2,1366,1308,3,58,1
11,2,1295,1381,1,86,0
11,2,1315,1305,3,10,1
49,2,1294,1334,1,40,0
72,1,1303,1354,3,51,1
85,2,1344,1313,2,31,1
58,1,1323,1334,5,11,1
80,2,1311,1338,5,27,0
61,2,1327,1322,5,5,1
5,2,1505,1500,3,5,1
7,2,1613,1500,5,113,1
33,1,1884,2500,19,616,1
64,2,1819,1128,5,691,1
26,1,1134,1372,5,238,1
51,1,1137,1533,3,396,1
41,2,1217,1149,4,68,1
48,2,1206,1163,7,43,1
20,2,1242,1176,7,66,1
25,2,1147,1520,13,373,0
20,1,1156,1297,5,141,1
11,2,1329,1166,3,163,1
63,2,1445,1172,5,273,1
19,0,1176,1090,7,86,0
21,2,1379,1149,5,230,1
134,1,1155,1459,8,304,1
129,2,1381,1163,3,218,1
39,2,1540,1169,4,371,1
33,1,1171,1648,8,477,1
22,1,1171,1500,3,329,1
60,1,1172,1760,7,588,1
87,2,1434,1179,7,255,1
62,1,1190,1337,5,147,1
22,1,1698,1154,4,544,0
12,2,1500,1154,6,346,1
41,2,1558,1154,5,404,1
40,1,1158,1521,6,363,1
71,2,1758,1160,6,598,1
107,1,1162,1606,5,444,1
41,2,1561,1166,5,395,1
37,2,1939,1167,3,772,1
23,2,1510,1171,4,339,1
30,1,1173,1751,2,578,1
1,2,1670,1175,1,495,1
51,2,1573,1179,5,394,1
47,1,1184,1500,1,316,1
73,2,2038,1957,4,81,1
154,1,1965,2087,7,122,1
40,1,1420,1964,6,544,1
41,2,1951,1975,3,24,0
45,2,2000,1962,13,38,1
51,2,2052,1971,13,81,1
146,1,1987,1900,7,87,0
76,1,1821,1979,7,158,1
144,1,1996,1886,10,110,0
43,1,1673,1992,7,319,1
70,1,1672,1988,4,316,1
45,2,1983,1764,3,219,1
89,2,1971,1965,4,6,1
70,1,2006,1956,4,50,0
29,2,1955,1454,3,501,1
71,2,1668,1976,8,308,0
24,1,1978,2457,2,479,1
29,1,1651,1974,9,323,1
57,2,1963,1942,7,21,1
76,1,1972,2072,10,100,1
20,2,1971,1184,3,787,1
39,2,1971,1317,4,654,1
118,1,1774,1965,11,191,1
71,1,1975,2015,3,40,1
57,2,1972,1643,6,329,1
41,2,2042,1982,4,60,1
48,1,1872,1973,7,101,1
63,2,1962,1924,3,38,1
60,1,1974,1990,3,16,1
31,2,1588,1996,1,408,0
29,2,1993,1609,3,384,1
29,2,2007,2005,2,2,1
33,2,1754,1500,2,254,1
46,1,1300,1495,9,195,1
63,2,1433,1508,2,75,0
62,1,1707,1775,4,68,1
59,2,1762,1833,4,71,0
53,2,1750,1775,1,25,0
29,2,1765,1761,5,4,1
150,1,2054,2123,10,69,1
122,0,1666,1701,10,35,0
143,2,1690,1677,7,13,1
132,1,1702,1664,8,38,0
30,1,1715,1651,7,64,0
41,2,1705,1661,8,44,1
64,1,1708,1694,5,14,0
150,0,1694,1709,2,15,0
87,2,1697,1705,7,8,0
52,1,1716,1684,4,32,0
110,1,1696,1706,6,10,1
107,2,1695,1708,2,13,0
157,0,1708,1694,8,14,0
49,2,1682,1721,3,39,0
64,2,1648,1695,6,47,0
2,0,1646,1696,2,50,0
33,0,1696,1500,3,196,0
71,2,1631,1710,5,79,0
84,1,1830,1694,2,136,0
67,2,1679,1834,6,155,0
62,1,1869,1670,3,199,0
37,2,1877,1675,6,202,1
143,2,1661,1762,4,101,0
56,2,1753,1670,3,83,1
40,1,1691,1670,5,21,0
139,1,2295,2127,8,168,0
63,2,2127,2295,11,168,0
19,2,2292,1794,6,498,1
76,1,1575,2291,8,716,1
35,2,2291,1576,9,715,1
36,2,1500,1804,4,304,0
117,2,1289,1455,4,166,0
90,1,1466,1458,3,8,0
26,2,1458,1363,5,95,1
64,1,1367,1450,5,83,1
87,2,1536,1459,3,77,1
25,1,1345,1452,11,107,1
76,1,1459,1569,2,110,1
71,2,1447,1479,11,32,0
54,1,1454,1613,4,159,1
106,2,1502,1463,11,39,1
91,2,1451,1514,2,63,0
40,1,1463,1413,5,50,0
42,1,1423,1453,3,30,1
74,1,1455,1442,2,13,0
111,2,1488,1451,3,37,1
30,1,1459,1566,2,107,1
53,1,1475,1314,3,161,0
47,2,1451,1477,6,26,0
111,2,1468,1386,4,82,1
54,2,1858,1450,3,408,1
118,1,1453,1772,6,319,1
63,2,1447,1273,8,174,1
24,1,1457,1510,3,53,1
68,1,1363,1448,3,85,1
41,2,1429,1460,6,31,0
15,2,1453,1316,4,137,1
56,1,1388,1444,5,56,1
82,1,1260,1438,2,178,1
33,2,1429,1377,4,52,1
64,1,1439,1453,4,14,1
68,2,1555,1447,3,108,1
46,2,1478,1458,2,20,1
84,1,1408,1448,1,40,1
57,2,1437,1418,3,19,1
40,2,1540,1446,3,94,1
42,1,1438,1698,6,260,1
50,2,1752,1441,2,311,1
52,1,1444,1815,2,371,1
30,1,1449,1636,3,187,1
39,2,2076,1450,5,626,1
44,2,1427,1359,8,68,1
58,1,1425,1415,2,10,0
52,1,1423,1533,4,110,1
30,1,1573,1407,7,166,0
77,2,1391,1601,3,210,0
108,1,1060,1134,3,74,1
38,1,1124,1790,1,666,1
41,2,1460,1153,1,307,1
36,1,1203,1422,1,219,1
33,2,1672,1203,2,469,1
10,1,1402,1208,2,194,0
37,2,1689,1500,3,189,1
115,2,1349,1306,4,43,1
35,2,1500,1349,5,151,1
88,1,1404,1326,6,78,0
39,2,1466,1439,4,27,1
26,0,1275,1467,6,192,0
17,2,1429,1282,4,147,1
77,2,1127,1108,2,19,1
74,1,1254,1256,3,2,1
34,1,1172,1162,5,10,0
29,2,1264,1289,3,25,0
46,1,1500,1435,3,65,0
96,1,1619,1574,4,45,0
10,1,1575,1640,3,65,1
104,1,1654,1561,4,93,0
74,0,1558,1657,5,99,0
51,2,1574,1569,4,5,1
20,1,1678,1675,6,3,0
38,1,1777,1648,8,129,0
58,1,1652,1624,8,28,0
4,1,1645,1679,4,34,1
46,1,1894,2133,9,239,1
64,1,2135,2118,3,17,0
36,1,2021,2107,5,86,1
115,2,2095,2029,6,66,1
110,1,2092,2080,3,12,0
81,2,2110,2095,3,15,1
137,2,2262,2104,2,158,1
43,2,2081,2243,2,162,0
63,2,2062,2140,3,78,0
54,1,1928,2051,2,123,1
101,2,2203,2061,9,142,1
66,1,2073,2195,5,122,1
84,1,2077,2443,5,366,1
42,2,2440,2081,15,359,1
28,1,2085,2436,5,351,1
37,2,2432,2090,3,342,1
47,2,2351,2097,2,254,1
60,1,2104,2340,4,236,1
72,1,2123,2116,7,7,0
33,2,2105,2145,3,40,0
83,2,2125,2115,7,10,1
52,1,2140,2244,9,104,1
57,2,2220,2157,5,63,1
45,2,2157,1380,4,777,1
109,2,2157,1569,12,588,1
45,2,2157,2000,7,157,1
50,1,2173,2287,6,114,1
150,1,2160,2214,5,54,1
110,1,2175,2322,4,147,1
51,2,2304,2194,3,110,1
158,1,2213,2323,5,110,1
50,1,2234,2352,5,118,1
43,2,2343,2259,2,84,1
68,1,2290,2317,6,27,1
50,1,1803,2285,5,482,1
55,2,2409,2314,12,95,1
15,2,1620,1651,7,31,0
45,2,1618,1630,5,12,0
77,1,1644,1728,5,84,1
82,1,1667,1807,13,140,1
24,1,1813,1602,9,211,0
15,1,1647,1745,5,98,1
36,1,1796,1680,8,116,0
4,1,1650,1895,1,245,1
38,1,1221,1783,1,562,1
27,2,1839,1229,6,610,1
50,1,1500,1406,4,94,0
51,2,1487,1200,4,287,1
45,2,1706,1208,1,498,1
6,1,1500,2113,4,613,1
62,1,2209,1500,6,709,0
32,2,2489,1500,4,989,1
65,2,2489,1500,4,989,1
56,1,1242,1216,9,26,0
46,1,1248,1417,8,169,1
20,1,1252,1498,3,246,1
100,1,1248,1342,4,94,1
71,2,1227,1260,4,33,0
81,2,1386,1268,6,118,1
47,2,1250,1475,5,225,0
82,1,1237,1615,5,378,1
109,2,1227,1191,7,36,1
67,2,1218,1158,3,60,1
57,2,1210,1100,4,110,1
26,1,1036,1179,1,143,1
41,2,1172,1060,5,112,1
141,2,1167,1078,5,89,1
41,2,1148,1099,9,49,1
95,2,1139,1089,6,50,1
107,0,1141,1138,7,3,0
77,2,1130,1048,8,82,1
83,2,1034,1144,3,110,0
68,1,1159,1019,6,140,0
19,2,1149,1119,4,30,1
119,2,1195,1159,3,36,1
61,2,1148,1153,4,5,0
32,0,1154,1148,3,6,0
49,2,1149,1159,4,10,0
108,1,1172,1137,2,35,0
34,1,1129,1161,4,32,1
36,1,1174,1115,8,59,0
120,1,1184,1223,3,39,1
85,2,1172,1329,8,157,0
58,2,1162,1132,5,30,1
98,1,1172,1199,4,27,1
54,1,1181,1310,6,129,1
77,2,1836,1500,8,336,1
51,2,1972,1500,3,472,1
57,1,1424,1500,6,76,1
46,1,1424,1534,3,110,1
107,2,1534,1424,8,110,1
61,2,1500,1424,5,76,1
19,2,1673,1424,11,249,1
54,1,1396,1424,6,28,1
83,2,1424,1087,4,337,1
77,2,1424,1500,4,76,0
34,1,1330,1424,3,94,1
25,2,1500,1424,5,76,1
116,0,1424,1158,3,266,0
50,1,1424,1454,6,30,1
53,2,1662,1424,4,238,1
14,1,1424,1662,1,238,1
39,2,1500,1424,3,76,1
90,1,1500,1424,7,76,0
28,1,1424,1654,4,230,1
69,2,1666,1424,3,242,1
23,2,1414,1500,2,86,0
78,1,1453,1414,3,39,0
39,1,1414,1651,6,237,1
104,1,1477,1414,3,63,0
67,2,1414,1500,4,86,0
26,1,1500,1414,4,86,0
13,1,1414,1452,4,38,1
123,2,1500,1414,8,86,1
21,2,1500,1414,7,86,1
28,1,1414,1591,3,177,1
119,2,1787,1414,5,373,1
44,1,1414,1787,5,373,1
93,2,1097,1414,4,317,0
51,2,1414,1500,4,86,0
28,0,1500,1414,4,86,0
41,2,1414,1500,3,86,0
20,1,1414,1500,2,86,1
30,0,1500,1414,4,86,0
102,1,1426,1461,4,35,1
74,2,1635,1432,5,203,1
16,1,1570,1414,4,156,0
42,1,1500,2026,4,526,1
62,1,2045,1750,3,295,0
111,2,2045,1768,6,277,1
64,2,2045,1500,6,545,1
116,1,2045,1500,4,545,0
66,1,2045,2062,5,17,1
19,2,2045,1435,3,610,1
79,2,2045,1500,5,545,1
77,2,1500,1270,4,230,1
120,2,1539,1270,3,269,1
34,1,1500,1270,2,230,0
27,2,1500,1270,4,230,1
29,2,1270,1523,3,253,0
41,2,1399,1270,2,129,1
28,1,1274,1569,7,295,1
64,1,1500,1274,4,226,0
24,1,1278,1568,4,290,1
87,2,1390,1286,2,104,1
51,2,1286,1426,5,140,0
67,2,1312,1298,2,14,1
48,1,1305,1462,3,157,1
36,1,1305,1396,2,91,1
12,1,1305,1521,2,216,1
112,1,1483,1287,4,196,0
115,2,1500,1292,2,208,1
76,1,1500,1272,3,228,0
29,2,1253,1471,6,218,0
77,2,1323,1263,2,60,1
46,2,1417,1271,6,146,1
55,2,1808,1191,1,617,1
65,2,1808,1191,1,617,1
144,1,1808,1191,2,617,0
51,2,1808,1500,5,308,1
37,2,1808,1410,6,398,1
36,1,1500,1808,1,308,1
28,2,1808,1500,6,308,1
72,1,1191,1808,1,617,1
99,2,1808,1191,5,617,1
59,2,1500,1808,3,308,0
53,2,1791,1983,9,192,0
34,1,1437,1786,4,349,1
45,2,1782,1417,6,365,1
17,2,1766,1709,4,57,1
34,1,1500,1758,4,258,1
32,1,1777,1736,3,41,0
35,2,1710,1790,4,80,0
42,1,1805,1680,2,125,0
55,2,1641,1959,4,318,0
43,2,1586,1654,3,68,0
2,1,1500,1586,2,86,1
38,1,1457,1567,2,110,1
60,1,1567,1500,2,67,0
37,2,1645,1567,5,78,1
39,2,2274,1350,4,924,1
10,1,1406,1655,4,249,1
58,1,1998,1963,6,35,0
43,2,1894,1961,2,67,0
103,2,1923,1967,8,44,0
59,2,1886,1862,3,24,1
146,1,1505,1743,7,238,1
84,1,1743,1505,4,238,0
77,2,1994,1886,8,108,1
37,2,2014,1893,8,121,1
25,2,1748,1216,2,532,1
81,2,1087,1233,3,146,0
38,1,1244,1297,4,53,1
43,2,1218,1841,8,623,0
47,2,1662,1220,4,442,1
27,2,1405,1227,3,178,1
41,2,1227,1500,3,273,0
40,2,1652,1229,4,423,1
61,2,1431,1235,4,196,1
71,2,1222,1240,2,18,0
101,2,1183,1413,5,230,0
2,1,1392,1183,2,209,0
68,1,1500,1160,2,340,0
49,2,1427,1165,3,262,1
77,2,1382,1170,5,212,1
93,2,1359,1177,2,182,1
23,1,1286,1160,2,126,0
104,0,1160,1164,2,4,0
44,2,1140,1346,4,206,0
77,2,1451,1144,2,307,1
72,1,1148,1447,1,299,1
36,2,1443,1152,2,291,1
70,1,1156,1440,4,284,1
15,2,1328,1163,3,165,1
32,1,1145,1428,7,283,1
58,1,1154,1240,5,86,1
28,2,1441,1158,2,283,1
61,2,1150,1004,4,146,1
19,1,1157,1348,5,191,1
23,2,1342,1163,2,179,1
116,1,1173,1247,3,74,1
37,2,1426,1178,6,248,1
53,2,1397,1183,2,214,1
104,1,1189,1391,1,202,1
25,2,1434,1195,4,239,1
33,1,1201,1389,5,188,1
93,2,1298,1198,2,100,1
121,2,1477,1203,2,274,1
56,1,1208,1421,8,213,1
32,1,1214,1448,1,234,1
95,2,1443,1219,2,224,1
65,2,2076,1831,10,245,1
75,1,2119,2076,3,43,0
100,1,2076,2119,4,43,1
70,1,2119,2076,4,43,0
60,1,2076,2119,4,43,1
93,2,2119,2076,4,43,1
56,1,2076,1992,4,84,0
97,1,1992,2076,2,84,1
36,0,1908,2076,3,168,0
73,2,2076,1893,8,183,1
25,2,1879,2076,1,197,0
84,1,2106,2031,4,75,0
98,0,2029,2047,4,18,0
68,1,2082,1970,2,112,0
64,1,2082,1988,2,94,0
133,0,1851,2082,10,231,0
159,2,2040,1983,2,57,1
11,2,1978,2004,2,26,0
22,1,1978,1979,6,1,1
75,2,1916,1887,3,29,1
81,2,1874,2020,8,146,0
52,1,2020,2027,4,7,1
40,1,1904,2020,4,116,1
62,1,1935,2020,3,85,1
35,2,2020,1938,4,82,1
52,1,1938,2020,5,82,1
67,2,2020,1938,4,82,1
48,1,1938,2020,9,82,1
38,1,2020,1938,3,82,0
75,2,2020,1985,2,35,1
65,2,2147,2020,5,127,1
32,2,2020,2160,9,140,0
41,2,2160,2020,2,140,1
57,2,1950,1835,5,115,1
40,2,1514,1672,5,158,0
74,1,1687,1557,6,130,0
51,2,1684,1394,6,290,1
68,1,1687,1993,11,306,1
38,1,1280,1685,7,405,1
90,1,1780,1671,8,109,0
99,0,1614,1673,9,59,0
53,1,1680,1799,4,119,1
113,2,1748,1689,3,59,1
57,1,1700,1684,7,16,0
54,1,1713,1658,9,55,0
65,2,1699,1812,5,113,0
25,1,1706,1839,5,133,1
114,0,1705,1709,9,4,0
72,0,1893,1700,8,193,0
59,2,1718,1711,6,7,1
45,2,1700,1714,9,14,0
10,1,1651,1690,3,39,1
49,2,1680,1661,4,19,1
115,2,1673,1510,9,163,1
45,2,1645,1686,5,41,0
46,1,1573,1678,2,105,1
62,1,1688,1716,5,28,1
64,1,1699,1706,6,7,1
36,1,1598,1703,3,105,1
81,2,1692,1682,11,10,1
46,1,1524,1686,8,162,1
34,1,1753,1672,3,81,0
113,2,1661,1653,6,8,1
92,1,1364,1657,5,293,1
53,2,1640,1881,4,241,0
68,1,1624,1629,6,5,1
100,1,1641,1619,3,22,0
69,0,1328,1500,4,172,0
27,2,1328,1500,5,172,0
27,2,1767,1330,5,437,1
15,2,2000,1331,4,669,1
46,1,1331,2043,3,712,1
60,1,1331,2209,2,878,1
24,1,1332,2043,4,711,1
67,2,1709,1334,5,375,1
37,2,1500,1334,3,166,1
50,2,1309,1347,3,38,0
37,2,1256,1363,5,107,0
24,1,1365,1751,6,386,1
54,1,1517,1346,3,171,0
8,1,1348,1756,5,408,1
26,1,1351,1726,4,375,1
21,2,2078,1351,5,727,1
48,1,1352,2041,4,689,1
38,1,1361,1430,5,69,1
45,2,1349,1346,4,3,1
64,0,1284,1348,5,64,0
19,2,1337,1297,5,40,1
27,2,1323,1340,4,17,0
29,2,1319,1037,3,282,1
64,1,1117,1312,1,195,1
23,2,1153,1330,3,177,0
23,1,1309,1317,4,8,1
45,2,1338,1314,2,24,1
50,2,1299,1378,5,79,0
72,1,1464,1500,9,36,1
109,2,1639,1656,4,17,0
35,2,1641,1490,1,151,1
63,2,1636,1260,1,376,1
20,2,1625,1378,1,247,1
59,2,1845,1638,3,207,1
64,1,1654,1839,9,185,1
70,1,1696,1563,1,133,0
19,2,1584,1500,5,84,1
19,2,1470,1090,3,380,1
15,2,1221,1105,2,116,1
11,2,1199,1123,2,76,1
13,2,1122,1160,2,38,0
11,2,1299,1176,2,123,1
55,2,1544,1528,5,16,1
94,1,1538,1564,3,26,1
41,2,1576,1548,5,28,1
28,1,1558,1610,3,52,1
69,2,1652,1566,4,86,1
112,1,1574,1678,5,104,1
54,1,1693,1559,11,134,0
41,1,1564,1761,8,197,1
77,2,1452,1579,4,127,0
83,2,1571,1459,8,112,1
51,2,1330,1590,2,260,0
82,1,1408,1584,3,176,1
24,1,1595,1581,10,14,0
66,1,1606,1637,5,31,1
26,1,1650,1592,4,58,0
106,1,1451,1585,3,134,1
89,1,1604,1306,4,298,0
45,1,1565,1594,5,29,1
37,2,1584,1545,7,39,1
78,1,1593,1654,6,61,1
84,1,1810,1575,9,235,0
115,2,1567,1473,3,94,1
56,2,1976,1569,4,407,1
64,1,1576,1719,4,143,1
23,2,1494,1589,3,95,0
67,2,1576,1635,6,59,0
94,1,1857,1852,5,5,0
94,1,1868,1675,3,193,0
32,1,1681,1862,8,181,1
42,1,1319,2296,3,977,1
35,2,2296,1319,3,977,1
44,1,1319,2296,3,977,1
41,2,2296,1319,5,977,1
57,2,2294,1742,6,552,1
48,1,1319,2294,3,975,1
39,2,2294,1319,5,975,1
32,1,1319,2294,2,975,1
19,2,2294,1319,7,975,1
35,2,2294,1319,4,975,1
32,1,1319,2294,4,975,1
9,2,2294,1319,6,975,1
27,2,1500,1016,2,484,1
54,1,1016,1016,6,0,0
29,2,1326,1016,4,310,1
80,1,1016,1326,2,310,1
85,2,1446,1016,3,430,1
41,2,1357,1016,4,341,1
36,1,1016,1357,2,341,1
8,2,1371,1016,2,355,1
57,2,1500,1016,2,484,1
64,2,1016,1230,2,214,0
77,2,1060,1016,3,44,1
3,1,1016,1608,2,592,1
47,2,1683,1016,4,667,1
54,1,1016,1766,4,750,1
35,2,1500,1016,3,484,1
61,2,1702,1016,6,686,1
13,2,1702,1016,6,686,1
32,1,1500,1016,2,484,0
46,1,1016,1119,4,103,1
40,1,1016,2621,1,1605,1
48,1,1016,2621,5,1605,1
61,2,1898,1017,4,881,1
2,1,1034,1353,2,319,1
48,1,1222,1400,2,178,1
41,2,1361,1293,4,68,1
26,1,1309,1770,2,461,1
71,1,1415,1472,2,57,1
79,2,1730,1500,1,230,1
25,1,1543,1517,8,26,0
57,2,1517,1420,4,97,1
25,2,1420,1517,3,97,0
51,2,1467,1530,5,63,0
47,2,1530,1413,8,117,1
34,1,1530,1547,7,17,1
39,2,1547,1530,1,17,1
78,1,1530,1516,2,14,0
45,2,1530,1503,4,27,1
54,1,1530,1529,7,1,0
38,1,1529,1530,11,1,1
96,0,1530,1543,2,13,0
60,1,1543,1518,1,25,0
53,2,1436,1518,3,82,0
30,1,1518,1593,2,75,1
99,2,1516,1518,5,2,0
70,1,1669,1502,4,167,0
53,1,1503,2041,7,538,1
53,2,1487,1685,2,198,0
75,2,1472,1593,3,121,0
35,2,1503,1472,4,31,1
53,2,1500,1472,4,28,1
136,1,1401,1618,1,217,1
74,1,1632,1533,5,99,0
45,0,1530,1635,5,105,0
50,1,1654,1368,5,286,0
95,2,1647,1531,5,116,1
154,1,1494,1640,3,146,1
108,1,1539,1632,4,93,1
118,0,1820,1616,7,204,0
109,2,1606,1594,6,12,1
55,2,1594,1608,4,14,0
115,2,1621,1605,3,16,1
43,1,1605,1593,7,12,0
100,1,1589,1928,4,339,1
39,2,1581,1493,3,88,1
36,1,1523,1571,3,48,1
10,1,1248,1568,4,320,1
59,2,1564,1318,4,246,1
92,1,1582,1590,4,8,1
210,1,1600,1571,4,29,0
83,2,1555,1711,4,156,0
29,2,2621,1555,10,1066,1
120,1,1584,1543,4,41,0
147,2,1536,1500,5,36,1
45,2,1594,1545,8,49,1
63,0,1546,1522,4,24,0
71,2,1575,1566,4,9,1
116,1,1562,1554,4,8,0
40,1,1567,1520,6,47,0
73,2,1500,1567,5,67,0
107,0,1566,1585,6,19,0
2,2,2430,1566,2,864,1
72,1,1538,1556,1,18,1
45,2,2209,2102,6,107,1
84,1,1988,2199,15,211,1
71,2,2179,2154,5,25,1
66,1,2164,2157,5,7,0
82,1,2181,2153,4,28,0
39,2,2148,2274,5,126,0
64,1,2262,2111,15,151,0
89,2,2098,1897,3,201,1
51,1,2022,2080,9,58,1
74,1,2114,2042,6,72,0
108,1,1956,2093,2,137,1
132,0,2109,1913,2,196,0
36,1,2151,2063,4,88,0
83,2,1946,2211,5,265,0
63,0,2214,2187,9,27,0
75,2,2173,2118,8,55,1
77,2,2175,2231,2,56,0
66,1,2239,2151,6,88,0
82,1,2250,2091,4,159,0
90,1,2120,2170,9,50,1
99,0,2148,2213,5,65,0
70,1,1887,2045,3,158,1
41,2,1500,1973,5,473,0
7,2,1689,1135,2,554,1
7,2,1686,1139,2,547,1
7,2,1693,1144,2,549,1
7,2,1690,1149,2,541,1
7,2,1737,1154,2,583,1
7,2,1630,1161,2,469,1
52,1,1987,1749,7,238,0
49,2,1987,1548,5,439,1
81,0,1987,1500,7,487,0
46,1,1500,1987,7,487,1
3,1,1987,1568,2,419,0
94,2,1568,1987,2,419,0
22,2,1568,1987,6,419,0
117,2,1987,1568,7,419,1
106,1,1568,1987,3,419,1
21,2,1987,1568,7,419,1
48,1,1568,1987,2,419,1
4,1,1987,1500,4,487,0
31,1,1987,1500,3,487,0
27,1,1987,1568,7,419,0
31,1,1987,1560,7,427,0
56,2,1519,1987,3,468,0
59,2,1987,1500,4,487,1
54,2,1559,1987,4,428,0
53,2,1789,1843,5,54,0
29,2,1707,1858,5,151,0
56,1,1872,1777,5,95,0
12,1,1423,1799,1,376,1
58,1,1404,1515,6,111,1
14,1,1500,1404,4,96,0
57,2,1667,1404,5,263,1
124,1,1404,1637,3,233,1
30,2,1404,1312,3,92,1
22,1,1312,1404,7,92,1
92,2,1404,1341,3,63,1
72,1,1749,1404,7,345,0
18,1,1749,1404,3,345,0
1,2,2100,1404,1,696,1
54,1,2009,1404,6,605,0
43,2,1643,1355,3,288,1
21,2,1368,1512,6,144,0
31,0,1500,1524,4,24,0
22,2,1858,1837,5,21,1
119,0,1852,1836,4,16,0
41,1,1847,1835,2,12,0
77,2,1838,1798,3,40,1
56,1,1892,1825,5,67,0
60,1,1836,1814,2,22,0
66,1,1826,1802,6,24,0
45,2,1793,1768,3,25,1
57,2,1751,1805,3,54,0
66,1,1814,1878,2,64,1
104,0,1813,1850,2,37,0
55,2,1837,1823,7,14,1
24,1,1839,1632,2,207,0
86,1,1853,1778,2,75,0
107,2,1874,1863,3,11,1
37,1,1873,1905,2,32,1
36,1,1575,1869,4,294,1
78,1,1818,1860,4,42,1
140,1,1922,1847,11,75,0
117,2,1839,1743,2,96,1
84,1,1857,1565,2,292,0
63,1,1868,1874,3,6,1
96,1,1879,1844,2,35,0
106,1,1912,1867,4,45,0
71,2,1609,1880,4,271,0
60,1,1893,1830,2,63,0
63,2,1962,1901,4,61,1
40,2,1708,1918,4,210,0
47,2,1907,1906,2,1,1
50,0,1979,1905,3,74,0
40,1,1916,1907,2,9,0
53,2,1904,1938,2,34,0
41,2,1964,1913,3,51,1
131,2,1904,1862,3,42,1
104,1,1847,1895,6,48,1
48,1,1908,1832,3,76,0
113,2,1900,1794,6,106,1
43,2,2018,1908,10,110,1
40,1,1786,1900,3,114,1
54,1,1847,1891,7,44,1
31,2,1881,1857,2,24,1
40,1,1831,1872,8,41,1
61,2,1862,1825,2,37,1
34,1,1874,1837,3,37,0
116,1,1319,1739,8,420,1
31,2,1739,1319,2,420,1
4,2,1589,1739,4,150,0
58,1,1500,1739,1,239,1
57,2,1739,1500,2,239,1
52,1,1500,1739,1,239,1
79,1,1342,1449,5,107,1
31,2,1605,1342,5,263,1
83,1,1629,1476,4,153,0
49,2,1629,1047,4,582,1
103,2,1627,1148,9,479,1
105,2,1617,1575,4,42,1
52,1,1509,1609,5,100,1
53,2,2334,1453,8,881,1
73,2,1500,1453,3,47,1
51,1,1461,1567,6,106,1
90,1,1133,1461,3,328,1
78,1,1477,1297,3,180,0
70,1,1303,1471,3,168,1
33,2,1464,1310,6,154,1
27,2,1456,1366,3,90,1
40,2,1385,1470,2,85,0
53,1,1299,1470,9,171,1
118,2,1453,1482,3,29,0
75,2,1467,1594,5,127,0
83,2,1613,1474,3,139,1
59,2,1474,1500,4,26,0
79,2,1466,1358,11,108,1
28,2,1047,1466,1,419,0
66,1,1380,1457,8,77,1
68,1,1468,1489,6,21,1
43,2,1462,1320,6,142,1
34,1,1161,1462,5,301,1
46,1,1305,1455,3,150,1
43,2,1343,1470,2,127,0
49,2,1461,1398,4,63,1
68,1,1502,1368,5,134,0
66,2,1517,1512,10,5,1
73,2,1546,1523,7,23,1
56,1,1533,1511,3,22,0
42,1,1522,1523,4,1,1
24,1,1534,1510,6,24,0
36,1,1524,1414,3,110,0
59,2,1514,1489,5,25,1
73,2,1526,1525,7,1,1
60,1,1525,1574,3,49,1
23,2,1533,1525,2,8,1
78,1,1525,1533,3,8,1
69,2,1596,1525,8,71,1
53,2,1630,1525,8,105,1
33,2,1536,1651,5,115,0
33,2,1500,1547,2,47,0
110,1,1567,1456,5,111,0
57,2,1553,1485,4,68,1
50,1,1500,1553,2,53,1
77,2,1514,1571,2,57,0
59,2,1610,1571,2,39,1
73,2,1418,1571,1,153,0
78,1,1450,1558,3,108,1
81,2,1430,1581,3,151,0
44,1,1169,1571,1,402,1
36,0,1501,1255,5,246,0
48,1,1261,1697,6,436,1
16,1,1269,1625,2,356,1
24,1,1276,1675,10,399,1
90,1,1287,1611,4,324,1
48,1,1312,1448,6,136,1
13,2,1173,1336,2,163,0
20,2,1391,1202,2,189,1
33,1,1244,1384,4,140,1
9,2,1443,1291,1,152,1
80,1,1388,1390,11,2,1
84,0,1433,1315,5,118,0
111,2,1803,1500,3,303,1
26,1,1500,1355,5,145,0
38,2,1506,1505,3,1,1
79,2,1488,1466,2,22,1
43,2,1488,1282,4,206,1
117,2,1434,1505,2,71,0
29,2,1491,1377,6,114,1
74,1,1491,1500,6,9,1
21,2,1483,1305,7,178,1
121,2,1483,1213,3,270,1
85,2,1478,1129,5,349,1
14,1,1209,1478,2,269,1
62,1,1312,1478,4,166,1
43,2,1618,1652,8,34,0
55,2,1515,1652,4,137,0
40,1,1500,1652,1,152,1
47,1,1120,1652,4,532,1
26,0,1652,1120,2,532,0
86,1,1652,1646,6,6,0
26,1,1450,1652,2,202,1
58,1,1657,1927,6,270,1
14,1,1669,1717,6,48,1
50,1,1565,1659,2,94,1
30,1,1037,1658,3,621,1
90,1,1671,1709,6,38,1
82,1,1487,1663,3,176,1
14,1,1670,1881,6,211,1
87,2,1884,1670,7,214,1
111,2,1828,1670,8,158,1
73,1,1670,1543,6,127,0
54,1,1670,1884,9,214,1
44,1,1670,1966,5,296,1
74,1,1497,1670,1,173,1
39,1,1670,1778,9,108,1
49,2,1659,1543,4,116,1
72,1,1673,1717,4,44,1
72,1,1640,1521,3,119,0
17,2,1645,1334,2,311,1
38,1,1386,1640,2,254,1
19,2,1634,1500,2,134,1
124,1,1648,1552,3,96,0
122,1,1501,1640,7,139,1
60,1,1723,1642,2,81,0
26,1,2163,2012,2,151,0
25,2,2094,2163,6,69,0
85,2,2153,2148,5,5,1
54,1,2082,2144,9,62,1
81,2,2136,2039,6,97,1
48,1,2136,2353,18,217,1
124,1,2133,2124,8,9,0
23,2,2401,2128,13,273,1
61,2,1800,2128,6,328,0
78,1,2144,2001,4,143,0
122,1,2145,2588,12,443,1
126,1,1437,1370,4,67,0
29,2,1500,1437,8,63,1
26,1,1427,1389,6,38,0
114,0,1383,1428,5,45,0
17,2,1417,1435,6,18,0
71,1,1681,1796,7,115,1
41,1,1806,1786,4,20,0
38,1,1739,1797,6,58,1
37,2,1782,1884,2,102,0
87,2,1879,1790,8,89,1
91,2,1775,1801,4,26,0
41,2,1884,1809,3,75,1
69,2,1812,1811,4,1,1
24,1,1738,1801,10,63,1
99,2,1881,1810,5,71,1
24,2,1696,1824,13,128,0
82,1,1832,1873,2,41,1
70,1,1841,1908,2,67,1
48,1,1658,1835,3,177,1
39,2,1822,1851,8,29,0
125,2,1756,1835,3,79,0
58,1,1848,1773,12,75,0
86,1,1858,1888,10,30,1
50,1,1948,1842,3,106,0
20,2,1955,1850,7,105,1
44,1,1862,1823,5,39,0
40,1,1748,1853,4,105,1
38,1,1820,1842,7,22,1
96,1,1850,1923,2,73,1
100,2,1782,1864,2,82,0
55,2,1858,1674,5,184,1
32,2,1963,1866,9,97,1
44,1,1868,2220,10,352,1
37,2,2048,1875,2,173,1
87,2,1859,1946,2,87,0
58,1,1888,1846,3,42,0
40,1,1859,1798,4,61,0
118,1,1838,1846,3,8,1
65,2,1828,2012,10,184,0
92,1,1877,1813,7,64,0
50,1,1823,1868,7,45,1
63,2,1938,1831,7,107,1
79,2,1831,1764,6,67,1
103,2,2048,1831,6,217,1
65,2,1831,2048,2,217,0
26,2,2048,1831,5,217,1
135,2,1765,1846,3,81,0
90,1,1784,1834,3,50,1
153,2,1817,1911,1,94,0
61,1,1878,1801,7,77,0
59,2,1850,1812,3,38,1
42,1,2018,1812,4,206,0
76,2,1908,1821,3,87,1
17,1,1147,1158,4,11,1
25,2,1845,1189,2,656,1
40,1,1271,1703,10,432,1
53,2,1439,1341,8,98,1
55,2,1697,1378,6,319,1
176,1,1440,1693,5,253,1
27,2,1836,1500,4,336,1
61,2,1478,1295,4,183,1
122,1,1303,1284,5,19,0
46,1,1292,1358,5,66,1
56,1,1303,1307,2,4,1
73,2,1333,1318,8,15,1
144,1,1327,1388,3,61,1
43,2,1500,1332,5,168,1
33,2,1391,1342,5,49,1
71,2,1494,1348,3,146,1
69,2,1338,1322,3,16,1
45,2,1337,1458,2,121,0
95,2,1374,1347,4,27,1
47,2,1336,1337,3,1,0
115,0,1437,1333,5,104,0
14,1,1422,1336,3,86,0
21,2,1325,1353,5,28,0
64,1,1334,1384,5,50,1
46,1,1478,1319,4,159,0
35,2,1308,1330,4,22,0
6,1,1344,1221,5,123,0
90,1,1351,1459,3,108,1
44,1,1443,1337,4,106,0
67,0,1579,1331,3,248,0
17,2,1445,1338,5,107,1
79,2,1426,1347,3,79,1
50,1,1355,1418,6,63,1
108,1,1365,1409,2,44,1
96,1,1267,1365,4,98,1
43,2,1365,1376,6,11,0
61,2,1347,1374,5,27,0
21,1,1384,1395,7,11,1
80,2,1346,1397,4,51,0
104,1,1408,1374,2,34,0
64,1,1372,1398,4,26,1
40,1,1382,1388,5,6,1
94,1,1381,1377,4,4,0
43,1,1381,1646,7,265,1
82,1,1384,1658,3,274,1
58,2,1688,1388,4,300,1
26,1,1584,1371,3,213,0
104,1,1500,2048,1,548,1
11,2,2048,1500,2,548,1
5,2,1500,2048,3,548,0
26,1,1500,2048,2,548,1
73,0,1647,1647,8,0,0
120,1,1677,1635,9,42,0
62,1,1645,1649,2,4,1
57,2,1788,1652,3,136,1
34,1,1683,1640,4,43,0
70,1,1651,1650,7,1,0
39,2,1661,1661,2,0,0
18,0,1661,1661,4,0,0
82,1,1673,1603,2,70,0
22,1,1658,1663,8,5,1
90,1,1673,1729,10,56,1
51,2,1666,1553,2,113,1
49,2,1647,1678,4,31,0
61,2,1799,1684,4,115,1
61,2,1500,1694,4,194,0
54,1,1703,1735,2,32,1
74,1,1828,1715,11,113,0
56,2,1776,1724,10,52,1
56,1,1734,1747,2,13,1
41,2,1722,1773,2,51,0
60,1,1802,1709,2,93,0
56,1,1726,1789,2,63,1
79,2,1778,1722,3,56,1
100,0,1745,1707,11,38,0
95,2,1758,1725,9,33,1
76,1,1735,1753,2,18,1
44,2,1837,1743,3,94,1
61,2,1734,1714,2,20,1
60,1,1744,1748,2,4,1
42,1,1756,1737,2,19,0
93,2,1831,1765,3,66,1
57,2,1811,1774,10,37,1
106,1,1796,1762,3,34,0
49,2,1844,1771,10,73,1
116,1,1799,1760,11,39,0
86,1,1769,1838,2,69,1
42,1,1788,1757,10,31,0
47,2,1746,1745,2,1,1
32,1,1749,2040,2,291,1
70,1,1804,1736,3,68,0
21,2,1724,1770,2,46,0
27,2,1254,1068,2,186,1
26,1,1103,1240,3,137,1
31,2,1465,1119,3,346,1
36,1,1140,1457,4,317,1
11,2,1409,1173,3,236,1
69,2,1452,1210,3,242,1
24,1,1332,1299,3,33,0
35,2,1498,1500,4,2,0
128,0,2270,2451,4,181,0
56,1,2451,2270,9,181,0
48,1,1930,2270,9,340,1
16,1,2108,2270,6,162,1
19,2,2270,2199,1,71,1
42,1,2199,2270,5,71,1
2,2,2270,1962,2,308,1
107,0,1962,2270,9,308,0
44,1,1750,2270,2,520,1
41,2,2264,1838,2,426,1
29,2,2259,1775,1,484,1
52,1,1974,2243,3,269,1
43,2,2230,1929,8,301,1
126,1,1821,2221,4,400,1
16,1,1821,2211,2,390,1
65,2,2204,1740,1,464,1
25,2,2185,1916,9,269,1
62,1,1807,2172,2,365,1
46,1,1500,1510,2,10,1
49,2,1510,1500,3,10,1
21,2,1683,1500,3,183,1
52,1,1500,1683,2,183,1
75,2,1327,1500,3,173,0
39,2,1370,1500,5,130,0
65,0,1500,1370,4,130,0
70,0,1500,1370,3,130,0
91,2,1370,1500,4,130,0
72,0,1370,1500,4,130,0
96,1,1500,1370,2,130,0
88,1,1500,1370,2,130,0
49,2,1370,1500,3,130,0
5,2,1370,1500,3,130,0
44,1,1500,1370,2,130,0
75,2,1370,1500,3,130,0
44,1,1500,1370,3,130,0
50,0,1370,1500,3,130,0
54,1,1270,1279,3,9,1
44,1,1298,1695,2,397,1
46,1,1348,1573,2,225,1
43,2,1565,1445,5,120,1
58,1,1500,1860,2,360,1
77,2,1338,1607,7,269,0
172,1,1500,1338,4,162,0
64,1,1547,1317,4,230,0
72,1,1322,1557,4,235,1
117,2,1527,1329,1,198,1
80,1,1341,1398,4,57,1
62,1,1286,1328,3,42,1
102,1,1331,1695,5,364,1
24,0,1346,1343,6,3,0
1,2,1778,1349,1,429,1
46,1,1353,1661,2,308,1
85,2,1645,1353,5,292,1
54,1,1356,1752,7,396,1
57,2,1804,1358,3,446,1
44,1,1359,2109,2,750,1
113,2,1361,1373,3,12,0
66,1,1381,1731,3,350,1
102,1,1116,1376,1,260,1
2,1,1381,1651,2,270,1
64,1,1389,1561,2,172,1
37,2,1747,1392,5,355,1
64,1,1422,1173,2,249,0
108,1,1631,1783,4,152,1
74,1,1791,1867,2,76,1
40,1,1636,1784,4,148,1
45,2,1699,1798,4,99,0
108,1,1813,1683,3,130,0
65,2,1884,1815,6,69,1
42,2,1675,1322,3,353,1
7,2,1476,1500,4,24,0
51,2,1278,1058,4,220,1
13,2,1143,1097,5,46,1
41,2,1014,1287,2,273,0
27,2,1206,1014,6,192,1
16,1,1071,1312,2,241,1
27,2,1424,1092,4,332,1
36,1,1127,1333,4,206,1
17,2,1785,1132,5,653,1
47,2,1500,1132,7,368,1
22,1,1144,1601,4,457,1
27,2,2066,1145,2,921,1
85,2,1505,1617,6,112,0
37,1,1367,1505,4,138,1
38,1,1511,1680,7,169,1
43,1,1524,1518,8,6,0
43,2,1549,1536,2,13,1
45,2,1525,1430,7,95,1
174,1,1460,1514,3,54,1
39,2,1498,1531,4,33,0
63,2,1482,1525,5,43,0
82,2,1464,1496,7,32,0
52,1,1506,1610,6,104,1
15,2,1500,1516,5,16,0
30,2,1414,1534,3,120,0
25,2,1525,1377,5,148,1
3,2,1329,1547,1,218,0
9,2,1541,1277,4,264,1
20,2,1290,1541,5,251,0
76,1,1358,1532,4,174,1
22,2,1522,1364,9,158,1
50,1,1431,1510,5,79,1
17,2,1495,1440,11,55,1
43,2,1478,1513,3,35,0
114,0,1514,1477,4,37,0
60,2,1500,1514,6,14,0
56,1,1392,1501,5,109,1
106,1,1525,1370,2,155,0
49,2,1346,1552,4,206,0
51,1,1570,1569,10,1,0
33,2,2621,1122,4,1499,1
34,1,1405,1420,2,15,1
21,2,1578,1420,2,158,1
51,2,1406,1496,3,90,0
46,2,1309,1420,3,111,0
30,1,1432,1397,6,35,0
13,2,1441,1442,5,1,0
18,1,1453,1432,3,21,0
71,2,1420,1465,4,45,0
21,2,1463,1476,5,13,0
32,1,1438,1467,5,29,1
51,2,1458,1478,2,20,0
146,1,1456,1478,4,22,1
111,2,1466,1503,3,37,0
156,1,1435,1456,2,21,1
53,2,1426,1456,3,30,0
35,1,1521,1443,4,78,0
172,1,1372,1434,5,62,1
113,2,1423,1479,3,56,0
43,2,2156,1621,5,535,1
81,2,2156,1511,4,645,1
62,1,1991,2156,13,165,1
52,1,1322,2156,2,834,1
2,1,2156,2476,2,320,1
58,2,2156,1725,5,431,1
62,1,2156,1959,9,197,0
76,1,1359,2156,3,797,1
24,2,2156,1220,3,936,1
76,1,1889,1999,5,110,1
21,2,1903,1898,2,5,1
34,1,1955,1885,4,70,0
39,1,1894,1938,5,44,1
104,1,1868,1884,4,16,1
19,2,1543,1006,2,537,1
23,1,1010,1530,1,520,1
37,2,1488,1015,1,473,1
48,1,1016,1429,1,413,1
29,2,1500,1016,3,484,1
14,1,1059,1224,2,165,1
51,2,2162,1278,9,884,1
30,1,1281,1684,6,403,1
29,2,1663,1284,5,379,1
44,1,1285,1869,6,584,1
60,1,1286,1972,8,686,1
99,2,1253,1917,5,664,0
77,2,1869,1254,3,615,1
45,1,1257,1658,6,401,1
35,2,1789,1258,5,531,1
52,1,1263,1554,5,291,1
34,2,1483,1270,3,213,1
124,1,1543,1210,8,333,0
16,1,1212,1743,6,531,1
63,2,1193,1360,5,167,0
106,1,1564,1689,9,125,1
77,2,1689,1703,4,14,0
105,2,1807,1689,10,118,1
81,2,1689,1500,8,189,1
97,0,1689,1790,6,101,0
50,1,1689,1748,3,59,1
72,2,1720,1500,3,220,1
59,2,1653,1569,6,84,1
106,1,1569,1653,5,84,1
105,2,1685,1666,4,19,1
90,1,1688,1423,2,265,0
57,2,1588,1706,3,118,0
69,2,1699,1508,2,191,1
77,2,1491,1722,3,231,0
35,2,1720,1245,2,475,1
119,2,1714,1479,2,235,1
70,1,1483,1708,2,225,1
30,1,1471,1702,2,231,1
70,1,1725,1451,2,274,0
61,2,1431,1750,3,319,0
63,2,1746,1403,2,343,1
72,1,1482,1741,4,259,1
79,2,1550,1763,5,213,0
71,2,1758,1458,2,300,1
41,2,1591,1778,3,187,0
3,2,1775,1379,2,396,1
116,1,1381,1772,1,391,1
113,2,1769,1383,2,386,1
64,1,1456,1765,4,309,1
71,2,1762,1361,5,401,1
52,1,1785,1489,6,296,0
70,1,1387,1783,2,396,1
43,2,1778,1484,2,294,1
116,1,1543,1772,2,229,1
51,2,1770,1247,6,523,1
39,2,1767,1424,5,343,1
24,0,1500,1243,2,257,0
54,1,1243,1500,2,257,1
25,2,1500,1243,2,257,1
43,2,1805,1273,4,532,1
38,1,1277,1803,2,526,1
113,2,1800,1282,4,518,1
36,1,1287,1798,6,511,1
22,1,1500,1287,4,213,0
65,2,1901,1287,4,614,1
33,2,1511,1309,3,202,1
47,2,1500,1500,12,0,0
30,1,1500,2282,11,782,1
26,1,1500,1500,8,0,0
28,1,1500,1500,10,0,0
27,2,1500,1500,4,0,0
45,2,1500,1500,18,0,0
1,2,2617,1500,1,1117,1
42,1,1500,2016,4,516,1
41,2,2272,1500,10,772,1
30,2,2473,1500,4,973,1
27,2,2401,1500,4,901,1
47,2,2326,1500,4,826,1
53,2,1433,1272,2,161,1
26,1,1500,1387,3,113,0
41,2,1500,1260,2,240,1
77,2,1257,1414,6,157,0
73,2,1398,1265,2,133,1
75,2,1253,1196,6,57,1
22,0,1194,1255,3,61,0
43,2,1413,1263,3,150,1
49,2,1771,1265,4,506,1
71,2,1343,1276,10,67,1
56,1,1266,1556,2,290,1
17,2,1552,1270,4,282,1
150,1,1272,1785,9,513,1
81,2,1710,1274,3,436,1
96,1,1279,1528,4,249,1
17,2,1254,1560,4,306,0
63,2,1468,1260,5,208,1
78,1,1263,1664,4,401,1
69,2,1662,1265,5,397,1
7,2,1659,1268,3,391,1
48,1,1274,1503,5,229,1
108,1,1698,1247,3,451,0
72,1,1257,1325,8,68,1
26,1,1268,1341,4,73,1
61,2,1329,1279,4,50,1
69,2,1409,1289,8,120,1
55,1,1299,1400,3,101,1
44,1,1223,1286,6,63,1
20,1,1289,1686,5,397,1
46,2,1933,1499,5,434,1
53,2,2137,1939,7,198,1
22,1,1963,1380,2,583,0
73,2,2242,1967,9,275,1
3,2,1515,1412,2,103,1
23,2,1721,1500,1,221,1
11,0,1500,1210,1,290,0
89,2,1746,1744,5,2,1
143,2,1734,1738,2,4,0
120,1,1741,1871,7,130,1
42,1,1686,1731,6,45,1
89,0,1635,1723,8,88,0
128,1,1553,1717,6,164,1
71,2,1708,1652,5,56,1
64,1,1648,1698,3,50,1
98,0,1698,1720,5,22,0
119,2,1545,1714,9,169,0
127,2,1702,1421,4,281,1
24,1,1679,1692,9,13,1
119,2,1795,1700,8,95,1
65,0,1702,1700,5,2,0
101,2,1686,1782,2,96,0
55,2,1676,1661,5,15,1
97,2,1581,1690,11,109,0
123,2,1679,1694,7,15,0
47,2,1669,1636,8,33,1
164,1,1484,1663,3,179,1
17,2,1697,1673,1,24,1
137,2,1660,1685,3,25,0
42,1,1696,1695,3,1,0
77,2,1690,1533,8,157,1
66,2,1690,1701,8,11,0
79,1,1734,1688,5,46,0
66,1,1688,1745,6,57,1
43,2,1684,1700,6,16,0
105,0,1645,1702,6,57,0
58,1,1555,1673,4,118,1
65,2,1670,1352,6,318,1
75,2,1690,1679,4,11,1
80,1,1597,1670,13,73,1
61,2,1728,1441,1,287,1
62,1,1448,1705,5,257,1
154,2,1676,1457,2,219,1
120,1,1468,1633,3,165,1
188,1,1478,1668,4,190,1
117,0,1467,1686,2,219,0
28,1,1710,1431,1,279,0
26,1,1424,1708,1,284,1
40,1,1734,1384,5,350,0
65,1,1390,1730,1,340,1
111,0,1742,1372,2,370,0
44,1,1377,1738,4,361,1
63,2,1734,1383,2,351,1
89,2,1690,1371,1,319,1
51,1,1380,1654,3,274,1
89,0,1759,1364,5,395,0
55,1,1364,1738,3,374,1
47,2,1738,1364,4,374,1
37,1,1364,1738,2,374,1
65,2,1738,1364,3,374,1
98,1,1364,1738,5,374,1
125,2,1348,1291,2,57,1
62,1,1302,1338,5,36,1
53,2,1174,1302,2,128,0
40,1,1303,1654,2,351,1
41,1,998,1299,4,301,1
62,1,1110,1292,1,182,1
58,1,1220,1281,2,61,1
36,1,1226,1287,2,61,1
53,2,1273,1290,3,17,0
39,2,1230,1563,2,333,0
3,2,1560,1160,3,400,1
43,2,1445,1576,3,131,0
64,1,1588,1574,2,14,0
36,2,1375,1606,1,231,0
54,1,1619,1595,2,24,0
52,1,1627,1508,6,119,0
23,2,1625,1257,2,368,1
48,1,1465,1618,5,153,1
52,1,1631,1593,3,38,0
36,2,1482,1648,3,166,0
49,2,1678,1658,3,20,1
18,1,1680,1048,5,632,0
43,1,1691,1682,5,9,0
31,2,1761,1700,10,61,1
60,1,1362,1697,6,335,1
116,1,1554,1689,2,135,1
11,2,1681,1571,4,110,1
53,2,1668,1697,4,29,0
52,1,1151,1666,2,515,1
38,1,1678,1649,5,29,0
53,1,1698,1241,7,457,0
61,2,1726,1709,9,17,1
123,2,1700,1673,5,27,1
74,1,1514,1694,4,180,1
31,2,1689,1417,6,272,1
64,1,1658,1678,8,20,1
68,1,1314,1675,3,361,1
33,2,1670,1460,5,210,1
147,2,1662,1542,2,120,1
60,1,1689,1648,2,41,0
23,2,1503,1664,5,161,0
25,2,1654,1573,5,81,1
47,2,1643,1611,11,32,1
125,0,1677,1639,2,38,0
34,1,1654,1516,5,138,0
79,2,1648,1665,9,17,0
46,1,1652,1653,3,1,1
45,2,1631,1665,3,34,0
37,2,1659,1470,2,189,1
33,2,1610,1672,3,62,0
80,1,1615,1636,1,21,1
49,2,1857,1632,4,225,1
36,1,1640,1849,4,209,1
41,2,1850,1904,6,54,0
35,2,1894,1865,3,29,1
76,1,1696,1854,3,158,1
7,2,1842,1703,4,139,1
119,2,1826,1772,6,54,1
95,2,1812,1691,5,121,1
77,2,1803,1574,6,229,1
143,2,1806,1823,5,17,0
49,2,1783,1847,4,64,0
45,1,1298,1347,5,49,1
15,2,1343,1061,3,282,1
95,2,1195,1002,8,193,1
60,1,1004,1453,4,449,1
25,1,1274,982,4,292,0
116,1,1302,963,1,339,0
111,0,1174,956,2,218,0
27,2,1055,965,3,90,1
69,2,1379,967,3,412,1
54,0,962,1133,4,171,0
83,2,1240,958,7,282,1
55,2,945,964,5,19,0
61,2,1176,950,6,226,1
53,2,1174,955,2,219,1
106,0,1126,950,2,176,0
32,1,960,1005,3,45,1
64,1,964,1249,3,285,1
23,2,1475,1177,7,298,1
113,0,1180,1091,4,89,0
69,2,1308,1190,7,118,1
26,1,1193,1594,6,401,1
89,2,1566,1196,10,370,1
35,2,1582,1199,6,383,1
75,2,1956,1574,4,382,1
71,2,1934,1518,6,416,1
104,1,1754,1824,6,70,1
56,1,1605,1521,5,84,0
39,2,1594,1608,10,14,0
72,2,1792,1600,3,192,1
136,1,1612,1561,11,51,0
65,2,1604,1489,7,115,1
150,1,1615,1627,11,12,1
90,1,1498,1579,1,81,1
14,1,1178,1744,1,566,1
93,2,1099,1132,1,33,0
23,2,1500,1099,3,401,1
7,2,1322,1142,7,180,1
32,1,1202,1347,3,145,1
12,1,1211,1804,3,593,1
57,2,1366,1500,1,134,0
42,1,2197,2116,4,81,0
70,1,2116,2197,3,81,1
65,2,2191,2041,5,150,1
62,1,2048,2184,12,136,1
44,1,2200,2015,11,185,0
35,2,2195,1964,8,231,1
92,1,2182,2184,6,2,1
54,1,1952,2179,8,227,1
54,1,1957,2174,7,217,1
60,1,1964,2169,4,205,1
65,2,2258,2177,11,81,1
50,1,2014,2171,9,157,1
86,2,1354,1914,1,560,0
54,1,2493,1914,12,579,0
51,2,1896,1910,4,14,0
64,1,1883,1877,9,6,0
168,1,1885,2107,13,222,1
66,1,2021,1857,5,164,0
52,1,1954,1831,5,123,0
55,2,1803,1934,12,131,0
51,2,1776,1888,7,112,0
82,1,1903,1744,11,159,0
37,2,1713,1848,3,135,0
16,2,1689,1690,6,1,0
48,1,1701,1662,3,39,0
23,2,1629,1713,5,84,0
36,1,1727,1590,5,137,0
23,2,1559,1577,3,18,0
42,1,1183,1552,10,369,1
31,2,1511,1602,3,91,0
68,1,1620,1462,3,158,0
151,2,1788,1473,2,315,1
39,1,1487,1729,9,242,1
60,2,1288,1487,5,199,0
60,1,1487,1288,4,199,0
68,1,1603,1429,3,174,0
66,0,1431,1418,2,13,0
85,2,1403,1486,2,83,0
82,1,1776,1383,4,393,0
42,1,1402,1682,7,280,1
18,2,1677,1425,5,252,1
39,2,1231,1531,3,300,0
129,2,1619,1531,5,88,1
112,1,1678,1395,2,283,0
18,1,1459,1499,3,40,1
55,2,1409,1507,5,98,0
101,2,1353,1406,2,53,0
95,2,1284,1373,4,89,0
63,2,1194,1449,5,255,0
13,2,1376,1248,4,128,1
60,1,1340,1366,3,26,1
36,1,1500,1707,5,207,1
42,1,1269,1162,4,107,0
58,1,1500,1258,3,242,0
124,0,1020,1228,1,208,0
16,1,1027,1478,1,451,1
43,2,1281,1047,2,234,1
14,1,1072,1276,2,204,1
39,2,1226,1112,1,114,1
40,1,1112,1239,2,127,1
7,2,1230,1170,3,60,1
38,1,1269,1219,2,50,0
19,2,1396,1379,3,17,1
56,1,1560,1601,5,41,1
24,1,1570,1587,5,17,1
53,2,1581,1581,3,0,0
36,1,1590,1614,6,24,1
47,2,1595,1539,7,56,1
38,1,1494,1587,4,93,1
66,1,1504,1578,3,74,1
69,1,1589,1573,5,16,0
89,2,1579,1565,4,14,1
78,1,1557,1569,4,12,1
46,1,1576,1683,4,107,1
42,1,1588,1554,6,34,0
58,1,1564,1578,3,14,1
56,1,1588,1595,5,7,1
63,2,1578,1576,7,2,1
75,2,1561,1589,5,28,0
27,2,1515,1602,3,87,0
21,2,1604,1613,4,9,0
71,2,1603,1609,8,6,0
73,2,1614,1613,3,1,1
84,1,1630,1420,3,210,0
62,1,1564,1621,4,57,1
41,2,1617,1343,5,274,1
25,2,1611,1443,7,168,1
86,1,1621,1650,10,29,1
100,1,1602,1611,6,9,1
56,1,1528,1603,4,75,1
23,2,1559,1615,3,56,0
36,1,1626,1612,2,14,0
92,1,1637,1630,5,7,0
51,2,1738,1645,2,93,1
61,2,1640,1436,2,204,1
65,2,1755,1647,6,108,1
33,1,1365,1653,2,288,1
71,2,1645,1664,3,19,0
49,2,1653,1684,5,31,0
50,1,1641,1638,7,3,0
24,2,1621,1738,10,117,0
57,2,1620,1632,1,12,0
23,2,1623,1566,5,57,1
66,1,1634,1619,5,15,0
93,2,1640,1644,3,4,0
83,2,1581,1657,9,76,0
71,2,2006,1906,8,100,1
62,1,1906,2006,5,100,1
53,2,1931,1915,6,16,1
37,1,1927,1797,4,130,0
32,1,1717,1640,11,77,0
67,2,1500,1403,8,97,1
76,1,1916,1698,2,218,0
68,1,1148,1916,3,768,1
61,2,1841,1916,14,75,0
45,2,1916,1213,11,703,1
37,2,1916,1562,2,354,1
26,1,1429,1916,10,487,1
35,2,1916,843,8,1073,1
53,2,1808,1916,6,108,0
76,1,1755,1672,4,83,0
37,2,1661,1694,4,33,0
39,2,1679,1565,6,114,1
49,1,1375,1671,4,296,1
60,1,1539,1654,4,115,1
18,1,1629,1629,2,0,0
104,1,1722,1592,4,130,0
30,1,1612,1714,6,102,1
51,2,1705,1635,9,70,1
110,0,1653,1633,5,20,0
59,2,1621,1673,10,52,0
99,0,1514,1479,4,35,0
82,1,1489,1504,3,15,1
99,2,1480,1432,6,48,1
56,1,1489,1540,7,51,1
124,0,1510,1488,11,22,0
30,1,1593,1474,4,119,0
72,1,1485,1470,4,15,0
49,2,1470,1625,7,155,0
50,1,1478,1560,9,82,1
54,1,1491,1425,4,66,0
30,1,1341,1484,6,143,1
87,2,1547,1493,3,54,1
47,2,1482,1508,5,26,0
61,2,1472,1450,4,22,1
57,2,1438,1484,7,46,0
40,1,1497,1426,6,71,0
23,2,1527,1507,2,20,1
16,1,1518,1516,9,2,0
58,1,1529,1518,5,11,0
56,1,1499,1519,6,20,1
23,2,1508,1509,4,1,0
27,2,1516,1173,2,343,1
13,2,1550,1194,2,356,1
105,2,1481,1235,2,246,1
10,1,1303,1475,1,172,1
58,1,1345,1701,2,356,1
27,2,1500,1500,2,0,0
57,2,1718,1608,4,110,1
100,1,1608,1511,2,97,0
73,1,1693,1591,4,102,0
53,2,1580,1520,5,60,1
64,1,1530,1568,2,38,1
119,2,1480,1584,2,104,0
38,1,1531,1569,4,38,1
106,1,1571,1554,1,17,0
31,2,1544,1427,2,117,1
54,1,1434,1534,4,100,1
30,1,1517,1519,6,2,1
28,1,1549,1504,4,45,0
52,1,1746,1479,2,267,0
32,1,1640,1456,4,184,0
117,2,1560,1467,2,93,1
44,1,1589,1445,6,144,0
58,1,1445,1428,4,17,0
34,1,1621,1403,6,218,0
60,1,1407,1390,7,17,0
46,1,1277,1378,4,101,1
58,1,1375,1361,2,14,0
129,2,1690,1365,2,325,1
17,2,1252,1387,1,135,0
3,2,1359,1401,3,42,0
109,2,1384,1420,3,36,0
76,1,1445,1210,2,235,0
60,1,1466,1405,1,61,0
78,1,1492,1646,3,154,1
98,1,1487,2008,1,521,1
62,1,1503,1569,3,66,1
96,0,1511,1363,2,148,0
39,2,1499,1315,1,184,1
73,2,1480,1389,4,91,1
49,1,1397,1459,6,62,1
152,1,1491,1383,5,108,0
43,2,1474,1312,3,162,1
52,1,1477,2047,2,570,1
40,1,1490,1709,3,219,1
63,2,1462,1413,2,49,1
21,2,1435,1500,6,65,0
59,2,1404,1357,2,47,1
46,0,1355,1409,8,54,0
40,1,1444,1491,2,47,1
50,1,1104,1430,3,326,1
108,1,1441,1807,2,366,1
80,1,1715,1343,6,372,0
51,2,1744,1174,2,570,1
42,1,1177,1510,2,333,1
131,2,1423,1182,3,241,1
86,1,1185,1542,2,357,1
47,2,1421,1190,4,231,1
59,2,1450,1195,4,255,1
159,2,1301,1204,2,97,1
62,1,1211,1354,3,143,1
14,1,1228,1812,1,584,1
34,1,1228,1500,1,272,1
11,0,1500,1210,1,290,0
26,1,1038,1523,3,485,1
61,2,1523,1038,3,485,1
60,1,1558,1764,3,206,1
69,2,1689,1630,2,59,1
11,2,1752,1740,4,12,1
41,2,1500,1594,2,94,0
60,1,1423,1584,4,161,1
11,2,1764,1500,2,264,1
65,2,1445,1649,4,204,0
25,2,1445,1649,3,204,0
141,2,1445,1649,3,204,0
93,2,1445,1649,3,204,0
48,1,1445,1649,2,204,1
30,1,1445,1649,7,204,1
40,1,1445,1649,5,204,1
52,1,1649,1445,2,204,0
27,2,1649,1445,7,204,1
121,1,1649,1445,5,204,0
28,1,1445,1649,5,204,1
91,2,1649,1445,10,204,1
105,1,1445,1649,6,204,1
60,1,1649,1445,4,204,0
123,2,1649,1445,9,204,1
80,1,1450,1649,5,199,1
99,2,1649,1440,3,209,1
128,1,1702,1649,8,53,0
85,2,1683,1649,4,34,1
89,2,1649,1330,4,319,1
33,2,1627,1649,4,22,0
95,2,1649,1447,2,202,1
2,1,1649,1703,2,54,1
3,2,1703,1649,3,54,1
42,1,1718,1649,4,69,0
29,1,1649,1608,5,41,0
43,2,1649,1888,5,239,0
26,1,1901,1629,8,272,0
60,1,1799,1611,9,188,0
33,2,1594,1750,4,156,0
46,1,1765,1577,8,188,0
9,2,1670,1577,6,93,1
41,2,1677,1577,2,100,1
42,1,1455,1569,7,114,1
31,2,1549,1427,4,122,1
86,1,1564,1437,3,127,0
80,0,1432,1568,5,136,0
31,2,1560,1440,5,120,1
48,1,1449,1551,7,102,1
129,1,1560,1596,5,36,1
67,2,1542,1469,5,73,1
114,1,1655,1526,4,129,0
66,1,1535,1579,9,44,1
67,2,1586,1500,3,86,1
30,2,1586,1452,2,134,1
2,1,1670,1345,1,325,0
182,1,1500,1500,1,0,0
149,0,1500,1500,3,0,0
42,1,1500,1500,3,0,0
68,1,1538,1553,8,15,1
49,2,1528,1517,5,11,1
36,1,1528,1594,6,66,1
123,2,1528,1442,8,86,1
50,2,1528,1790,9,262,0
58,1,1473,1518,3,45,1
8,2,1518,1760,8,242,0
10,2,1518,1545,3,27,0
8,2,1518,1368,5,150,1
126,0,1518,1438,5,80,0
10,0,1518,1760,8,242,0
8,0,1518,1875,8,357,0
10,0,1518,1500,10,18,0
29,1,1518,1760,8,242,1
5,2,1500,1518,5,18,0
24,1,1471,1509,6,38,1
74,1,1518,1603,8,85,1
99,2,1746,1523,7,223,1
86,1,1532,1597,7,65,1
89,2,1359,1532,3,173,0
49,1,1541,2460,5,919,1
50,1,1557,1409,5,148,0
39,2,1549,1439,5,110,1
47,2,1689,1556,8,133,1
71,2,1577,1567,8,10,1
43,2,1659,1489,3,170,1
45,2,1383,1489,6,106,0
133,2,1643,1924,9,281,0
34,2,1596,1573,9,23,1
39,2,1522,1627,7,105,0
39,2,1461,1434,4,27,1
32,1,1500,1461,2,39,0
31,2,1500,1500,4,0,0
80,1,1500,1519,2,19,1
23,2,1698,1612,2,86,1
39,2,1500,1327,1,173,1
114,1,1236,1304,5,68,1
110,1,1500,1288,6,212,0
87,2,1576,1288,9,288,1
67,2,1333,1302,6,31,1
84,2,1335,1318,4,17,1
34,1,1336,1324,5,12,0
67,2,1326,1141,5,185,1
64,1,1052,1318,2,266,1
27,2,1318,1181,6,137,1
27,2,1309,1101,11,208,1
28,1,1161,1297,6,136,1
58,1,1500,1297,3,203,0
39,1,1297,2027,4,730,1
131,2,1365,1313,3,52,1
31,2,1291,1295,6,4,0
27,2,1581,1298,3,283,1
34,1,1434,1265,8,169,0
43,2,1324,1284,6,40,1
13,2,1252,1360,5,108,0
62,2,1333,1272,5,61,1
55,2,1235,1376,9,141,0
99,2,1191,1269,4,78,0
44,2,1241,1200,5,41,1
112,1,1026,1224,3,198,1
46,1,1029,1204,3,175,1
21,2,1179,1050,4,129,1
62,1,1077,1146,5,69,1
32,1,982,1115,2,133,1
54,1,1005,1072,3,67,1
93,2,1011,1015,4,4,0
56,1,1026,916,3,110,0
52,1,992,1017,2,25,1
109,2,1483,1222,3,261,1
55,2,1573,1566,2,7,1
37,2,1561,1567,9,6,0
46,1,1533,1550,8,17,1
35,2,1538,1545,4,7,0
34,1,1385,1531,2,146,1
41,2,1508,2203,12,695,0
51,2,1498,1780,7,282,0
46,1,1857,1498,10,359,0
65,2,1570,1507,8,63,1
61,2,1547,1518,7,29,1
72,1,1527,1611,11,84,1
61,2,1406,1527,7,121,0
24,1,1344,1521,4,177,1
113,2,1514,1350,3,164,1
28,1,1520,1717,5,197,1
33,2,1538,1531,5,7,1
58,1,1542,1557,4,15,1
88,1,1454,1532,3,78,1
82,1,1654,1515,9,139,0
46,2,1537,1504,7,33,1
23,2,1984,1505,7,479,1
49,1,1356,1498,5,142,1
56,1,1499,1995,8,496,1
144,1,1512,1447,3,65,0
65,2,1578,1521,5,57,1
69,2,1506,1605,4,99,0
57,2,1757,1040,4,717,1
19,2,1757,1022,4,735,1
63,1,1757,1932,7,175,1
103,2,1757,1809,4,52,0
45,2,1962,1757,11,205,1
89,2,1741,1849,4,108,0
106,1,1731,1854,8,123,1
130,1,1922,1731,5,191,0
70,1,1731,1832,2,101,1
49,2,1731,1829,3,98,0
63,1,1989,1731,6,258,0
82,2,1731,1811,5,80,0
53,2,1859,1731,9,128,1
82,1,1731,1866,2,135,1
41,2,1944,1731,3,213,1
34,1,1731,1839,4,108,1
68,1,1881,1731,10,150,0
31,2,1806,1731,2,75,1
53,2,1731,1803,6,72,0
45,2,1713,1885,11,172,0
57,1,1856,1718,7,138,0
71,2,1701,1821,7,120,0
89,2,1947,1701,8,246,1
37,2,1701,1897,6,196,0
53,0,1859,1701,6,158,0
37,2,1701,1919,6,218,0
28,1,1858,1701,7,157,0
61,2,1701,1956,7,255,0
81,0,1868,1701,3,167,0
26,1,1701,1812,8,111,1
23,2,1822,1701,3,121,1
27,2,1833,1701,2,132,1
73,2,1701,1910,8,209,0
89,2,1897,1701,11,196,1
78,1,1701,1807,2,106,1
47,0,1841,1701,11,140,0
75,2,1832,1701,6,131,1
57,2,1510,1412,6,98,1
30,1,1479,1399,6,80,0
36,1,1409,1439,4,30,1
18,1,1426,1159,6,267,0
128,2,1428,1437,4,9,0
54,1,1449,1416,8,33,0
58,1,1497,1437,4,60,0
113,2,1507,1445,4,62,1
90,1,1390,1435,2,45,1
58,1,1451,1294,3,157,0
45,2,1451,1450,2,1,1
79,0,1449,1485,6,36,0
35,2,1362,1463,4,101,0
31,1,1488,1438,3,50,0
67,2,1574,1497,5,77,1
40,1,1506,1565,8,59,1
83,2,1394,1521,4,127,0
48,1,1531,1539,2,8,1
129,2,1531,1543,4,12,0
20,1,1253,1539,2,286,1
67,2,1673,1546,4,127,1
46,1,1553,1677,3,124,1
118,1,1557,1849,7,292,1
114,1,1934,1949,9,15,1
107,2,1949,2077,6,128,0
38,2,1949,1863,13,86,1
57,0,1776,1949,7,173,0
111,2,1949,1845,7,104,1
20,1,1845,1949,6,104,1
154,1,2057,1949,5,108,0
96,1,2057,1949,9,108,0
90,0,1949,2057,9,108,0
80,1,2033,1949,6,84,0
2,1,2021,1949,2,72,0
119,2,1949,1714,11,235,1
184,1,2276,1949,5,327,0
38,1,1874,1949,8,75,1
64,1,1883,1817,17,66,0
113,0,1707,1881,10,174,0
41,2,1500,1772,9,272,0
65,2,1392,1067,3,325,1
25,2,1342,1075,3,267,1
56,1,1077,1631,4,554,1
150,0,1057,1595,4,538,0
9,2,1286,1067,3,219,1
40,1,1068,1822,2,754,1
97,2,1428,1073,4,355,1
98,1,1291,1037,3,254,0
43,2,1612,1039,2,573,1
162,1,1006,1228,6,222,1
23,2,1553,1008,4,545,1
132,1,1015,1301,3,286,1
89,2,1297,1024,2,273,1
31,2,1738,1025,4,713,1
35,2,1130,1044,5,86,1
27,1,1047,1492,2,445,1
50,1,1335,1329,4,6,0
83,2,1321,1826,4,505,0
57,2,1826,1321,7,505,1
45,0,1364,1422,4,58,0
53,2,1422,1364,4,58,1
71,2,999,1375,6,376,0
74,1,1241,1430,2,189,1
77,2,1430,1241,2,189,1
55,2,1259,1324,4,65,0
57,2,1182,1459,5,277,0
27,2,1428,1110,6,318,1
32,1,1286,1318,5,32,1
102,1,1574,1303,3,271,0
69,2,1500,1022,2,478,1
75,2,1314,1196,2,118,1
94,1,996,1191,3,195,1
45,2,1185,1002,3,183,1
70,1,1009,1179,3,170,1
56,1,1187,1265,2,78,1
95,2,1107,1201,3,94,0
60,1,1307,1187,4,120,0
50,1,1194,1299,1,105,1
79,2,1287,1203,3,84,1
82,1,1047,1202,3,155,1
69,2,1047,1202,2,155,0
60,1,1047,1202,3,155,1
130,1,1217,1041,6,176,0
66,1,1253,1205,7,48,0
82,1,1212,1359,1,147,1
24,1,1194,1201,2,7,1
69,2,1356,1208,3,148,1
62,1,1214,1359,3,145,1
57,2,1352,1222,4,130,1
15,2,1206,1368,3,162,0
65,2,1306,1214,3,92,1
42,1,1223,1297,4,74,1
35,2,1212,1175,3,37,1
30,1,1218,1393,1,175,1
56,2,1386,1224,2,162,1
49,2,1315,1239,2,76,1
35,2,1264,1249,3,15,1
60,1,1257,1343,3,86,1
96,1,1264,1242,1,22,0
33,2,1352,1272,2,80,1
22,1,1281,1342,2,61,1
82,1,1331,1267,4,64,0
18,1,1380,1251,3,129,0
14,1,1023,1246,3,223,1
123,2,1240,1047,3,193,1
81,2,1233,1251,2,18,0
80,1,1446,1237,3,209,0
56,1,1243,1357,2,114,1
42,1,1305,1229,3,76,0
69,2,1215,1316,2,101,0
69,2,1281,1224,3,57,1
63,2,1209,1337,1,128,0
57,2,1297,1217,3,80,1
65,2,1202,1375,7,173,0
39,2,1330,1208,4,122,1
62,1,1217,1282,3,65,1
27,2,1832,1500,3,332,1
32,1,1500,2210,1,710,1
95,2,2002,2056,5,54,0
51,2,1997,1778,3,219,1
86,2,1988,1931,5,57,1
33,2,1916,2001,3,85,0
81,2,2194,2007,7,187,1
72,1,2013,2188,5,175,1
100,2,2010,2036,3,26,0
29,2,2035,1492,3,543,1
80,1,2046,2057,2,11,1
53,2,2046,2057,6,11,0
69,1,1994,2048,4,54,1
135,2,2047,1268,5,779,1
88,1,2055,2155,4,100,1
72,1,2050,2044,6,6,0
67,2,2034,2002,2,32,1
136,1,2046,2011,2,35,0
221,0,2111,2044,6,67,0
48,1,2054,2089,4,35,1
33,2,2063,2065,4,2,0
62,1,1906,2058,7,152,1
33,2,2050,1950,5,100,1
168,1,2003,2040,6,37,1
103,0,2040,2066,5,26,0
44,2,2328,2031,6,297,1
40,1,2035,2324,5,289,1
156,1,2005,2024,7,19,1
126,0,2025,2004,5,21,0
89,1,2036,2054,5,18,1
15,2,2044,2047,7,3,0
168,1,2143,2032,4,111,0
48,1,2046,1950,5,96,0
141,2,2038,1934,4,104,1
125,2,2151,2046,5,105,1
79,2,2294,2046,4,248,1
36,1,2046,2294,3,248,1
55,2,2120,2055,4,65,1
129,1,2070,1968,5,102,0
130,1,2081,2082,1,1,1
32,1,1407,1430,3,23,1
117,2,1418,1419,5,1,0
46,1,1500,1418,3,82,0
5,2,1500,1418,1,82,1
38,1,1418,1465,6,47,1
56,1,949,1416,6,467,1
103,2,1402,1481,7,79,0
83,2,1471,1412,3,59,1
38,1,1412,1500,4,88,1
52,1,1430,1250,2,180,0
69,2,1360,1440,4,80,0
57,2,1440,1968,4,528,0
27,2,1435,1216,4,219,1
9,2,1430,1187,7,243,1
147,2,990,1452,7,462,0
42,1,1104,1449,7,345,1
61,2,1441,1316,3,125,1
45,2,1424,1373,5,51,1
102,1,1424,2110,9,686,1
47,2,1424,1508,3,84,0
49,2,1415,1319,4,96,1
28,2,1408,1255,3,153,1
43,1,1262,1401,5,139,1
20,2,1401,1979,4,578,0
23,2,1392,1284,10,108,1
47,2,1392,1500,4,108,0
39,2,1739,1395,11,344,1
17,2,2043,1396,4,647,1
35,2,1385,1362,5,23,1
35,2,1500,1385,3,115,1
33,2,1526,1385,4,141,1
29,2,1500,1385,3,115,1
61,2,1377,1255,5,122,1
23,2,1377,1804,6,427,0
49,2,1377,1073,4,304,1
68,1,1377,1343,8,34,0
61,2,1343,1377,5,34,0
50,1,1635,1377,3,258,0
88,1,1764,1590,4,174,0
70,1,1770,1952,6,182,1
26,2,1938,1777,5,161,1
55,2,1887,1785,4,102,1
131,2,1966,1797,4,169,1
30,1,1804,1938,2,134,1
79,2,1848,1814,2,34,1
53,2,1806,1673,3,133,1
47,2,1824,1817,2,7,1
142,1,1829,1812,4,17,0
31,2,1800,1842,4,42,0
33,2,1831,1810,3,21,1
42,2,1927,1840,1,87,1
66,1,1870,1826,2,44,0
147,2,1810,1933,4,123,0
85,2,2049,1815,3,234,1
31,2,1926,1823,4,103,1
38,1,2278,1800,2,478,0
150,1,1823,2012,4,189,1
72,1,1846,1839,2,7,0
90,1,1594,1855,4,261,1
62,1,1500,1621,6,121,1
46,1,1645,1748,3,103,1
51,2,1542,1659,4,117,0
32,1,1746,1645,4,101,0
62,1,1655,1673,3,18,1
120,1,1667,1659,4,8,0
49,2,1654,1693,4,39,0
77,2,1748,1671,9,77,1
35,2,1671,1500,4,171,1
14,1,1671,1500,3,171,0
11,2,1681,1738,3,57,0
91,2,1731,1691,4,40,1
62,1,1707,1678,5,29,0
25,2,1663,1790,4,127,0
47,2,1705,1674,4,31,1
58,1,1717,1460,2,257,0
55,2,1712,1499,4,213,1
38,1,1730,1473,8,257,0
43,2,1704,1731,10,27,0
50,1,1801,1717,6,84,0
57,2,1714,1718,6,4,0
69,2,1803,1723,2,80,1
90,1,1732,1785,4,53,1
173,2,1719,1758,6,39,0
43,2,1748,1730,6,18,1
66,1,1741,1743,4,2,1
103,2,1264,1763,4,499,0
40,1,1232,1761,4,529,1
90,1,1742,1750,8,8,1
107,2,1747,1424,3,323,1
34,2,1735,1763,2,28,0
126,1,1755,1722,4,33,0
108,1,1757,1709,3,48,0
100,1,1720,1748,4,28,1
64,1,1773,1706,5,67,0
66,1,1717,1709,4,8,0
45,2,2247,1718,6,529,1
5,1,2055,2036,2,19,0
92,1,2295,2055,2,240,0
98,2,2055,2441,6,386,0
20,1,1450,1626,1,176,1
27,0,1436,1525,3,89,0
81,2,1673,1464,3,209,1
28,1,1536,1353,6,183,0
64,1,1240,1272,4,32,1
74,1,1303,1613,7,310,1
61,2,1479,1407,5,72,1
105,2,1551,1500,4,51,1
79,0,1874,1824,6,50,0
45,2,1824,1874,6,50,0
103,2,1783,1874,3,91,0
63,2,1754,1874,4,120,0
86,0,1874,1754,2,120,0
35,2,1915,1874,7,41,1
85,2,1874,1882,3,8,0
144,1,1604,1869,3,265,1
17,2,1848,1869,4,21,0
27,2,1869,1964,10,95,0
142,0,1669,1869,3,200,0
25,2,1869,1652,9,217,1
95,2,1664,1869,8,205,0
44,1,1628,1869,2,241,1
40,1,1869,1628,4,241,0
9,2,1628,1869,3,241,0
104,0,1359,1258,5,101,0
56,1,1371,1326,8,45,0
31,2,1346,1386,8,40,0
66,2,1334,1341,7,7,0
15,2,1321,1393,7,72,0
77,2,1310,1303,3,7,1
36,1,1321,1283,6,38,0
112,1,1334,1253,5,81,0
6,1,1141,1328,5,187,1
32,2,1321,1167,3,154,1
37,2,1307,1381,5,74,0
46,1,1315,1390,7,75,1
76,2,1302,1349,4,47,0
83,2,1292,1250,2,42,1
100,0,1289,1372,5,83,0
45,1,1290,1760,3,470,1
23,2,1316,1301,9,15,1
24,1,1303,1705,8,402,1
48,1,1386,1288,9,98,0
23,2,1730,1290,8,440,1
46,1,1299,1356,2,57,1
48,1,1312,1152,7,160,0
57,2,1303,1294,3,9,1
50,1,1314,1295,7,19,0
46,1,1313,1383,5,70,1
11,2,1301,1394,7,93,0
45,2,1283,1107,4,176,1
16,2,1276,1132,5,144,1
61,2,1255,1233,3,22,1
38,1,1268,1202,7,66,0
50,1,1280,1214,10,66,0
56,2,1269,1338,5,69,0
80,1,1278,1316,3,38,1
54,2,1266,1307,2,41,0
54,1,1278,1220,2,58,0
9,1,1278,1135,2,143,0
39,2,1266,1295,7,29,0
45,2,1257,1192,8,65,1
25,2,1249,1147,7,102,1
66,1,1261,1186,8,75,0
80,1,1500,2154,2,654,1
43,2,1673,1839,11,166,0
54,1,1839,1673,16,166,0
35,2,1673,1839,11,166,0
50,1,1839,1673,11,166,0
23,2,1673,1839,11,166,0
50,1,1839,1673,9,166,0
9,2,2181,2327,6,146,0
115,0,2322,2472,5,150,0
69,2,2315,2128,1,187,1
77,2,2309,2091,1,218,1
102,1,2075,2303,4,228,1
87,2,2303,1286,2,1017,1
130,1,2130,2296,8,166,1
140,1,2293,2282,8,11,0
90,1,1371,2282,1,911,1
131,2,2273,2138,1,135,1
63,2,2267,2022,1,245,1
70,1,1433,2267,2,834,1
58,1,1371,2267,1,896,1
122,1,1540,2266,2,726,1
80,1,1301,2266,2,965,1
34,1,2277,1371,3,906,0
151,2,2312,2277,4,35,1
58,1,2201,2266,6,65,1
47,2,2258,2123,1,135,1
51,2,2250,2119,1,131,1
74,1,2126,2240,5,114,1
69,0,2235,2258,11,23,0
61,2,2246,2204,1,42,1
38,1,1351,1378,6,27,1
38,1,1351,1360,5,9,1
56,1,1060,1351,4,291,1
104,1,1519,1444,4,75,0
55,2,1508,1511,3,3,0
69,2,1568,1517,3,51,1
41,2,1594,1526,4,68,1
63,2,1609,1534,3,75,1
68,2,1526,1445,7,81,1
161,2,1513,1601,7,88,0
40,1,1527,1400,8,127,0
35,2,1613,1535,7,78,1
102,1,1548,1465,3,83,0
108,1,1507,1529,11,22,1
43,2,1660,1536,10,124,1
51,1,1548,1503,3,45,0
90,1,1566,1536,10,30,0
50,1,1546,1595,7,49,1
75,2,1532,1640,5,108,0
32,1,1458,1524,3,66,1
62,1,1497,1514,11,17,1
60,1,1530,1502,5,28,0
50,1,1512,1548,4,36,1
56,1,1522,1518,10,4,0
82,1,1535,1484,5,51,0
79,1,1520,1524,3,4,1
49,2,1562,1534,6,28,1
70,1,1547,1490,7,57,0
51,2,1612,1556,3,56,1
60,1,1568,1534,7,34,0
88,1,1544,1558,4,14,1
83,2,1547,1555,5,8,0
58,1,1758,1530,4,228,0
26,1,1540,1556,7,16,1
83,1,1554,1456,2,98,0
98,1,1599,1545,3,54,0
70,1,1555,1570,5,15,1
36,1,1563,1654,5,91,1
50,1,1577,1483,6,94,0
86,1,1524,1567,3,43,1
74,1,1484,1558,11,74,1
35,2,1546,1601,9,55,0
65,2,1537,1460,5,77,1
71,2,1541,1548,3,7,0
68,1,1562,1480,5,82,0
69,2,1471,1576,3,105,0
80,1,1316,1572,2,256,1
50,1,1585,1502,8,83,0
53,2,1516,1598,3,82,0
92,1,1460,1591,2,131,1
76,1,1629,1731,3,102,1
30,1,1500,1629,8,129,1
35,2,1629,1500,8,129,1
29,1,1854,1799,3,55,0
56,0,1891,1854,5,37,0
67,2,1903,1864,5,39,1
52,1,1811,1854,1,43,1
73,2,1847,1707,5,140,1
60,1,1622,1842,10,220,1
31,2,1374,1500,1,126,0
77,2,1956,1715,3,241,1
53,2,1707,1596,1,111,1
59,2,1730,1718,6,12,1
130,0,1710,2053,7,343,0
142,1,1726,1582,2,144,0
109,2,1713,1738,3,25,0
58,1,1431,1735,4,304,1
68,1,1739,1986,9,247,1
44,2,1853,1748,2,105,1
68,1,1758,1745,6,13,0
77,2,1977,1763,4,214,1
86,1,1767,2050,6,283,1
56,1,1712,1757,6,45,1
61,2,1741,1874,1,133,0
81,2,1978,1746,5,232,1
60,1,1741,1901,6,160,1
61,2,1729,1726,4,3,1
56,1,1738,1717,5,21,0
55,2,1712,1463,4,249,1
32,1,1174,1712,3,538,1
70,1,1500,1076,1,424,0
36,1,1076,1500,1,424,1
11,2,1500,1076,1,424,1
37,1,1115,1219,1,104,1
60,1,1774,1500,3,274,0
40,1,1500,1774,4,274,1
36,1,1500,1774,4,274,1
67,2,1774,1500,4,274,1
124,1,1774,1785,6,11,1
66,1,1683,1774,4,91,1
43,0,1774,1683,5,91,0
128,1,1683,1774,4,91,1
72,1,1500,1774,1,274,1
42,1,1500,1769,3,269,1
73,2,1764,1544,6,220,1
32,1,1224,1763,4,539,1
21,2,1756,1569,4,187,1
57,2,1753,1441,3,312,1
59,2,1745,1598,5,147,1
11,2,1727,1711,6,16,1
145,2,1599,1744,3,145,0
17,2,1742,1321,6,421,1
30,1,1529,1736,3,207,1
90,1,1577,1730,3,153,1
59,2,1728,1290,3,438,1
54,1,1742,1576,4,166,0
30,1,1484,1738,5,254,1
54,1,1449,1729,5,280,1
15,2,1725,1480,6,245,1
20,1,1485,1720,3,235,1
51,2,1714,1489,6,225,1
115,2,1579,1731,9,152,0
80,1,1749,1559,2,190,0
81,2,1583,1767,6,184,0
41,2,1764,1404,8,360,1
42,1,1484,1760,7,276,1
55,1,1779,1496,4,283,0
17,2,1278,1801,6,523,0
31,2,1139,1801,8,662,0
73,2,1801,1500,5,301,1
14,2,1500,1801,5,301,0
23,2,1801,1500,4,301,1
99,2,1421,1801,5,380,0
87,2,1429,1801,1,372,0
3,0,1292,1339,3,47,0
109,2,1329,1303,4,26,1
44,2,1449,1337,3,112,1
57,2,1628,1341,8,287,1
15,2,1500,1346,6,154,1
53,2,1193,1362,8,169,0
26,1,1251,1354,2,103,1
106,1,1407,1333,2,74,0
75,2,1463,1341,6,122,1
83,2,1327,1425,5,98,0
53,2,1544,1332,2,212,1
44,1,1341,1409,3,68,1
90,1,1313,1330,1,17,1
58,1,1337,1532,3,195,1
91,2,1525,1343,4,182,1
22,1,1350,1501,5,151,1
41,2,1211,1366,4,155,0
54,1,1394,1353,7,41,0
130,1,1364,1373,3,9,1
26,1,1340,1353,3,13,1
42,1,1184,1346,4,162,1
79,1,1354,1483,5,129,1
97,2,1476,1362,3,114,1
76,1,1370,1606,6,236,1
125,1,1385,1277,3,108,0
122,1,1392,1542,6,150,1
86,1,1299,1371,3,72,1
24,1,1386,1285,5,101,0
189,2,1545,1393,2,152,1
14,2,1654,1397,4,257,1
11,1,1500,1397,4,103,0
46,1,1404,1554,6,150,1
63,2,1393,1427,5,34,0
69,2,1582,1399,4,183,1
114,1,1407,1555,3,148,1
74,1,1571,1389,6,182,0
48,1,1144,1384,6,240,1
15,2,1576,1390,4,186,1
63,2,1565,1397,4,168,1
18,1,1400,1712,6,312,1
17,2,1709,1404,5,305,1
35,2,1985,1405,4,580,1
53,2,1389,1525,2,136,0
112,1,1394,1610,6,216,1
60,1,1399,1638,5,239,1
166,1,2267,1500,9,767,0
62,1,1671,2266,7,595,1
67,2,2261,1940,12,321,1
56,1,1787,2258,7,471,1
56,1,1563,2258,7,695,1
67,2,2255,1806,11,449,1
34,1,2207,2239,5,32,1
42,1,1778,2236,3,458,1
35,2,2230,1942,11,288,1
72,1,1526,2229,9,703,1
27,2,2228,1526,3,702,1
36,1,2254,2117,3,137,0
68,1,1802,2251,4,449,1
86,1,1857,2247,3,390,1
89,2,2241,1923,2,318,1
16,1,1575,2240,5,665,1
57,2,2227,2107,13,120,1
28,1,1940,2220,3,280,1
85,2,2213,1900,8,313,1
89,2,2211,1731,5,480,1
57,2,2208,1748,4,460,1
74,1,1651,2206,1,555,1
37,2,2203,1718,6,485,1
48,1,1418,2203,5,785,1
101,2,1684,2239,2,555,0
54,1,1228,1305,2,77,1
44,1,1235,1444,3,209,1
26,1,1324,1215,3,109,0
33,2,1490,1220,3,270,1
74,1,1350,1198,3,152,0
40,1,1204,1447,2,243,1
29,2,1682,1206,4,476,1
73,1,1211,1541,2,330,1
85,1,1215,1546,2,331,1
61,2,1442,1221,3,221,1
38,1,1223,1681,2,458,1
75,2,1589,1227,5,362,1
37,2,1211,1264,3,53,0
81,2,1256,1164,4,92,1
34,1,1266,1254,2,12,0
44,1,1279,1207,3,72,0
69,2,1069,1295,2,226,0
28,1,1305,1293,8,12,0
26,1,1189,1298,5,109,1
51,2,1289,1199,4,90,1
13,2,1900,1695,4,205,1
30,1,1745,1683,3,62,0
115,0,1752,1744,1,8,0
48,2,1740,1812,1,72,0
85,2,1735,1749,4,14,0
82,1,2139,1557,8,582,0
95,0,1509,1573,6,64,0
157,2,1692,1678,8,14,1
30,1,1490,1500,5,10,1
100,1,1621,1487,6,134,0
66,1,1498,1503,3,5,1
45,2,1495,1509,6,14,0
99,2,1499,1468,3,31,1
76,1,1493,1488,7,5,0
32,1,1498,1533,3,35,1
11,2,1498,1509,2,11,0
28,1,1522,1456,4,66,0
18,1,1533,1543,6,10,1
112,2,1527,1357,4,170,1
20,1,1500,1520,3,20,1
47,2,1441,1533,6,92,0
61,2,1459,1547,2,88,0
42,1,1389,1540,6,151,1
67,2,1533,1398,5,135,1
4,1,1425,1525,3,100,1
48,2,1515,1503,4,12,1
96,1,1528,1458,4,70,0
96,1,1540,1516,6,24,0
71,2,1633,1524,2,109,1
28,1,1529,1729,3,200,1
107,2,1520,1468,3,52,1
40,1,1519,1671,3,152,1
58,1,1526,1640,4,114,1
83,2,1738,1633,5,105,1
99,0,1500,1897,4,397,0
76,1,1222,1234,5,12,1
79,2,1273,1016,4,257,1
38,1,1028,1212,3,184,1
32,1,1033,1415,2,382,1
108,1,1037,1541,4,504,1
39,2,1500,1041,4,459,1
119,2,1245,1079,1,166,1
113,2,1079,1500,4,421,0
82,0,1075,1120,2,45,0
23,1,1101,1114,5,13,1
95,2,1310,1117,4,193,1
11,2,1071,1191,5,120,0
55,2,1031,1063,3,32,0
63,2,1199,1054,3,145,1
52,1,1089,1152,6,63,1
31,2,1456,1467,2,11,0
58,1,1478,1488,2,10,1
57,2,1469,1445,1,24,1
99,2,1425,1481,2,56,0
93,2,1687,1487,1,200,1
77,1,1496,1543,1,47,1
57,2,1521,1507,2,14,1
53,1,1445,1497,4,52,1
77,2,1487,1457,3,30,1
125,2,1545,1497,3,48,1
99,2,1485,1519,3,34,0
110,1,1590,1471,2,119,0
68,2,1458,1509,1,51,0
35,2,1885,1460,2,425,1
54,1,1473,1381,3,92,0
128,1,1711,1456,2,255,0
40,1,1411,1446,2,35,1
68,1,1457,1466,3,9,1
33,2,1537,1464,6,73,1
105,2,1450,1551,2,101,0
58,1,1453,1796,3,343,1
4,2,1565,1453,2,112,1
129,2,1437,1645,1,208,0
113,2,1623,1442,3,181,1
95,2,1372,1456,2,84,0
74,1,1467,1430,4,37,0
57,2,1455,1511,2,56,0
63,2,1987,1456,2,531,1
45,2,1546,1464,6,82,1
127,2,1507,1473,2,34,1
116,1,1480,1607,2,127,1
48,1,1498,1469,2,29,0
86,1,1476,1601,4,125,1
32,1,1422,1467,3,45,1
94,1,1477,1484,1,7,1
41,2,1649,1483,3,166,1
66,1,1440,1474,4,34,1
69,2,1548,1482,3,66,1
93,2,1470,1538,4,68,0
70,1,1481,1464,2,17,0
121,2,1415,1493,1,78,0
93,2,1655,1499,5,156,1
89,2,1487,1547,2,60,0
45,2,1493,1498,3,5,0
58,1,1471,1488,2,17,1
62,1,1495,1608,1,113,1
70,1,1503,1591,3,88,1
143,2,1494,1453,4,41,1
99,2,1619,1501,3,118,1
73,2,1564,1510,2,54,1
47,1,1841,1940,10,99,1
33,2,1930,1850,10,80,1
72,1,1895,1919,4,24,1
117,2,1919,1502,4,417,1
64,2,1961,1930,6,31,1
58,1,1942,1951,6,9,1
65,1,1948,2159,12,211,1
38,2,1936,1930,7,6,1
38,2,1919,1949,4,30,0
62,1,1883,1939,5,56,1
35,2,1935,1631,7,304,1
36,2,1697,1955,4,258,0
156,1,1971,1858,8,113,0
30,1,1838,1962,4,124,1
76,1,1885,1952,2,67,1
46,2,1821,1970,6,149,0
62,1,1985,1921,8,64,0
53,2,1982,1644,5,338,1
25,1,1698,1977,8,279,1
43,2,1974,1653,7,321,1
67,2,1972,1483,4,489,1
110,1,1952,1960,6,8,1
62,2,1689,1981,6,292,0
62,1,1998,1880,11,118,0
66,1,1953,1986,10,33,1
142,0,1986,1993,12,7,0
19,2,1979,1786,12,193,1
120,0,1988,1730,19,258,0
21,2,1906,2004,4,98,0
78,1,1614,2002,3,388,1
31,2,1999,1590,7,409,1
58,1,1824,1992,3,168,1
13,2,1991,1374,8,617,1
67,2,2009,2004,4,5,1
56,1,1160,2001,4,841,1
85,2,1993,1860,4,133,1
81,2,2089,2003,10,86,1
69,2,1387,1397,7,10,0
64,1,1566,2254,8,688,1
31,2,1524,1160,9,364,1
87,2,1524,1500,3,24,1
42,1,1500,1524,5,24,1
66,1,1595,1483,3,112,0
114,1,1603,1727,2,124,1
80,2,1589,1635,5,46,0
115,2,1759,1608,2,151,1
149,2,2014,1610,6,404,1
56,1,1612,2011,5,399,1
54,1,1615,1965,8,350,1
20,1,1617,2028,3,411,1
126,1,1620,1986,2,366,1
55,2,2108,1623,5,485,1
38,1,1640,1567,4,73,0
103,2,1635,1436,2,199,1
72,1,1112,1073,3,39,0
83,2,1056,1165,9,109,0
70,1,1201,1275,1,74,1
101,2,1263,1251,3,12,1
111,2,1287,1205,4,82,1
48,1,1313,1330,6,17,1
119,2,1465,1500,2,35,0
106,1,1500,1500,3,0,0
67,2,1500,1500,4,0,0
57,2,1500,1500,3,0,0
59,2,1500,1500,3,0,0
79,2,1500,1500,3,0,0
46,1,1500,1500,1,0,0
59,2,1500,1500,4,0,0
52,0,1309,1305,2,4,0
107,2,1293,1317,6,24,0
75,1,2007,2184,5,177,1
27,1,1834,2181,3,347,1
50,1,1902,2176,3,274,1
104,1,1425,1174,4,251,0
11,2,1402,1191,6,211,1
21,2,1310,1267,5,43,1
55,2,1224,1133,3,91,1
45,2,1415,1259,5,156,1
79,2,1259,1425,8,166,0
61,2,1953,1703,8,250,1
87,2,1302,1724,5,422,0
15,2,1720,1383,5,337,1
49,2,1716,1309,5,407,1
14,0,1224,1148,2,76,0
62,1,1178,1172,3,6,0
25,2,1093,1195,5,102,0
34,1,1143,1237,3,94,1
40,1,1053,1060,6,7,1
44,1,1151,1200,4,49,1
28,1,1291,1320,3,29,1
26,2,1317,1291,5,26,1
13,1,1493,1291,3,202,0
47,2,1333,1291,2,42,1
119,0,1291,1500,2,209,0
35,2,1615,1291,5,324,1
8,0,1500,1017,3,483,0
108,1,1574,1500,7,74,0
57,2,1500,1574,3,74,0
60,1,1405,1511,1,106,1
42,1,1523,1477,2,46,0
46,1,1514,1512,4,2,0
41,2,1496,1546,4,50,0
24,2,1433,1509,2,76,0
47,2,1509,1520,5,11,0
83,2,1515,1301,3,214,1
14,1,1396,1507,3,111,1
63,1,1519,1482,3,37,0
57,1,1531,1521,2,10,0
57,2,1522,1434,6,88,1
29,1,1222,1519,1,297,1
43,2,1461,1532,6,71,0
48,1,1268,1528,4,260,1
86,1,1540,1505,2,35,0
99,2,1531,1475,2,56,1
57,2,1513,1542,4,29,0
62,1,1483,1533,7,50,1
80,1,1502,1533,8,31,1
123,2,1489,1545,5,56,0
43,1,1560,1430,4,130,0
74,2,1550,1571,6,21,0
53,2,1562,1503,5,59,1
43,1,1576,1352,3,224,0
59,2,1432,1576,3,144,0
59,2,1570,1370,7,200,1
72,1,1546,1560,1,14,1
77,2,1555,1361,3,194,1
66,1,1459,1555,2,96,1
31,2,1496,1568,4,72,0
70,1,1527,1558,3,31,1
80,1,1570,1538,2,32,0
132,1,1583,1496,3,87,0
43,2,1574,1510,4,64,1
40,1,1520,1565,3,45,1
47,2,1554,1530,4,24,1
7,2,1549,1344,2,205,1
12,1,1500,1543,3,43,1
70,1,1537,1532,4,5,0
62,2,1470,1545,3,75,0
64,1,1556,1550,3,6,0
62,1,1493,1546,2,53,1
28,1,1519,1536,5,17,1
59,2,1518,1823,6,305,0
81,2,1529,1528,5,1,1
52,1,1539,1533,6,6,0
81,2,1724,1561,7,163,1
11,2,1293,1048,8,245,1
9,2,1422,1065,3,357,1
7,2,1861,1066,4,795,1
32,1,1075,1524,1,449,1
6,1,1102,1323,1,221,1
57,2,1282,1161,1,121,1
42,1,1244,1273,1,29,1
47,2,1482,1311,3,171,1
25,2,1500,1311,3,189,1
152,1,1708,1726,5,18,1
51,2,1759,1737,4,22,1
93,2,1725,1742,5,17,0
51,2,1484,1743,7,259,0
49,1,1750,1684,7,66,0
17,2,1576,1767,5,191,0
89,1,1771,1588,4,183,0
75,1,1791,1484,7,307,0
121,1,1803,1778,9,25,0
45,2,1805,1815,7,10,0
44,1,1838,1818,6,20,0
64,1,1829,1843,9,14,1
116,0,1832,1752,2,80,0
126,1,1616,1826,3,210,1
61,2,1820,1621,7,199,1
72,1,1627,1814,3,187,1
41,1,1833,1609,10,224,0
10,1,1862,1827,5,35,0
121,2,1817,1839,5,22,0
45,0,1838,1877,8,39,0
88,1,1860,1496,8,364,0
88,1,1499,1857,4,358,1
93,2,1854,1502,7,352,1
58,1,1505,1851,3,346,1
35,2,1860,1863,5,3,0
60,1,1516,1860,3,344,1
34,2,1857,1519,7,338,1
101,2,1854,1523,6,331,1
88,1,1526,1850,2,324,1
54,1,1862,1843,11,19,0
173,0,1954,1859,4,95,0
104,2,1816,1872,3,56,0
178,0,1872,1876,8,4,0
72,1,1830,1861,2,31,1
84,1,1509,1859,4,350,1
71,2,1856,1517,5,339,1
71,2,1853,1525,3,328,1
49,2,1850,1528,6,322,1
50,1,1860,1886,7,26,1
30,1,1871,1865,9,6,0
69,2,1868,1519,8,349,1
142,1,1522,1865,3,343,1
102,1,1852,1855,4,3,1
58,1,1536,1796,5,260,1
39,2,2162,1538,6,624,1
61,2,1509,1482,8,27,1
39,2,1467,1563,7,96,0
118,1,1474,1839,5,365,1
24,1,1327,1450,6,123,1
14,1,1338,1356,3,18,1
20,1,1355,1450,5,95,1
11,1,1147,1355,3,208,1
12,2,1341,1421,3,80,0
111,2,1458,1373,6,85,1
36,2,1360,1388,3,28,0
41,1,1401,1346,5,55,0
26,1,1353,1542,6,189,1
29,2,1333,1586,3,253,0
49,2,1753,1335,2,418,1
38,1,1337,1720,3,383,1
23,2,1718,1340,6,378,1
46,1,1347,1677,4,330,1
55,1,1391,1345,6,46,0
100,1,1351,1674,3,323,1
63,2,1524,1358,8,166,1
46,1,1362,1650,3,288,1
49,2,1646,1365,4,281,1
47,1,1456,1369,6,87,0
35,1,1378,1447,3,69,1
23,1,1461,1364,6,97,0
4,1,1141,1358,3,217,1
7,2,1353,1148,3,205,1
26,1,1429,1333,11,96,0
47,2,1323,1281,8,42,1
26,1,1334,1345,4,11,1
22,1,1360,1332,1,28,0
70,1,1332,1372,3,40,1
52,1,1363,1623,5,260,1
44,2,2367,1760,2,607,1
104,1,1446,1436,7,10,0
67,1,1424,1421,5,3,0
43,2,1270,1277,3,7,0
37,1,1597,1500,2,97,0
47,2,1598,1500,8,98,1
34,1,1159,1745,4,586,1
26,2,1744,1163,6,581,1
56,1,1305,1497,6,192,1
42,1,1385,1740,2,355,1
33,1,1786,1817,10,31,1
46,1,1494,1817,5,323,1
17,2,1817,1494,7,323,1
44,1,1494,1817,5,323,1
98,1,2227,2271,9,44,1
112,0,2273,2225,4,48,0
63,2,2277,2235,10,42,1
100,1,2245,2264,4,19,1
61,2,2279,2255,17,24,1
77,2,2242,2305,11,63,0
93,2,2263,2253,6,10,1
68,0,2252,2295,3,43,0
164,1,2239,2241,17,2,1
71,2,2232,2252,11,20,0
55,2,2241,2244,9,3,0
90,1,2231,2230,11,1,0
52,1,2239,2321,6,82,1
39,2,1758,1387,5,371,1
80,1,1389,1755,8,366,1
69,2,1330,1403,3,73,0
34,1,1412,1492,4,80,1
56,1,1426,1357,3,69,0
107,2,1462,1437,10,25,1
42,1,1449,1463,6,14,1
79,2,1548,1458,3,90,1
49,2,1458,1459,6,1,0
77,1,1526,1443,3,83,0
56,2,1428,1510,6,82,0
38,1,1500,1428,1,72,0
84,1,1432,1700,5,268,1
87,2,1629,1439,4,190,1
103,2,1879,1441,3,438,1
95,2,1422,1635,8,213,0
89,2,1412,1344,4,68,1
39,2,2003,1413,4,590,1
47,2,1407,1222,6,185,1
19,1,1348,1407,3,59,1
81,1,1407,1347,9,60,0
44,2,1492,1407,3,85,1
32,1,1500,1407,1,93,0
37,2,1500,1407,4,93,1
69,2,1413,1419,9,6,0
79,1,1419,1500,8,81,1
109,0,1417,1463,8,46,0
53,2,1421,1430,5,9,0
38,1,1417,1417,2,0,0
32,1,1422,1706,2,284,1
71,1,1864,1398,3,466,0
31,2,1443,1410,3,33,1
92,1,1411,1916,4,505,1
60,1,1412,1398,4,14,0
83,1,1409,1468,4,59,1
103,2,1739,1412,8,327,1
51,1,1439,1390,9,49,0
34,1,1500,1500,2,0,0
4,1,1500,1829,2,329,1
18,1,1500,1500,1,0,0
20,1,1679,1640,2,39,0
42,1,1769,1624,3,145,0
151,0,1632,1621,4,11,0
126,1,1568,1622,2,54,1
51,2,1755,1630,9,125,1
67,2,1615,1731,5,116,0
46,1,1781,1598,3,183,0
30,1,1625,1668,5,43,1
123,2,1980,1627,3,353,1
76,1,1555,1618,7,63,1
44,2,1614,1318,2,296,1
112,1,1587,1604,3,17,1
60,1,1608,1875,2,267,1
18,1,1347,1604,6,257,1
49,1,1520,1595,3,75,1
69,2,1614,1607,8,7,1
66,1,1589,1604,3,15,1
50,1,1616,1802,4,186,1
46,1,1474,1609,7,135,1
60,1,1621,1566,4,55,0
52,1,1631,1665,4,34,1
52,1,1545,1622,9,77,1
51,2,1636,1633,6,3,1
27,2,1631,1284,4,347,1
32,1,1743,1616,3,127,0
39,2,1600,1761,5,161,0
49,2,1629,1611,9,18,1
158,1,1675,1597,7,78,0
51,2,1590,1461,2,129,1
94,1,1316,1586,3,270,1
102,1,1555,1569,6,14,1
135,2,1555,1454,5,101,1
55,2,1548,1567,9,19,0
55,2,1555,1576,5,21,0
95,1,1562,1715,6,153,1
69,2,1812,1575,5,237,1
31,2,1306,1409,3,103,0
34,1,1411,1953,7,542,1
57,2,1764,1411,5,353,1
57,2,1908,1414,3,494,1
57,2,1657,1384,4,273,1
114,2,1570,1440,4,130,1
27,2,1405,1437,3,32,0
39,2,1670,1485,7,185,1
26,1,1487,2097,4,610,1
55,2,1461,1388,3,73,1
35,2,1500,1505,8,5,0
4,0,1505,1500,4,5,0
26,2,1496,1505,4,9,0
33,2,1581,1545,4,36,1
139,2,1714,1577,4,137,1
67,2,1039,1070,3,31,0
118,1,1077,1299,1,222,1
67,1,970,1065,2,95,1
104,1,1962,2091,9,129,1
73,2,1884,1870,5,14,1
85,2,1686,2166,9,480,0
14,0,1774,1648,8,126,0
81,2,1348,1272,7,76,1
45,2,1257,1362,8,105,0
33,2,1352,1352,5,0,0
103,2,1546,1357,6,189,1
59,1,1357,1369,7,12,1
30,1,1371,1270,4,101,0
27,1,1279,1363,5,84,1
83,2,1354,1289,5,65,1
76,1,1319,1343,3,24,1
50,1,1500,1500,3,0,0
53,2,1500,1500,5,0,0
60,2,1948,1864,5,84,1
23,1,1292,1947,4,655,1
23,2,1941,1687,6,254,1
89,2,1938,1500,7,438,1
59,2,1925,1839,3,86,1
92,1,1853,1912,12,59,1
37,2,1898,1852,9,46,1
62,1,1432,1895,3,463,1
75,2,1916,1911,2,5,1
24,1,1932,1839,12,93,0
17,2,1925,1698,4,227,1
66,1,1703,1916,5,213,1
29,2,1916,1072,3,844,1
63,2,1913,1463,2,450,1
74,1,1465,1910,2,445,1
54,1,1941,1605,3,336,0
22,1,1608,1936,3,328,1
82,1,1576,1931,10,355,1
53,2,1927,1565,4,362,1
84,1,1528,1519,4,9,0
96,0,1531,1430,3,101,0
36,2,1669,1538,1,131,1
45,1,1545,1658,2,113,1
32,2,1607,1554,3,53,1
12,1,1564,1598,4,34,1
43,0,1527,1565,12,38,0
100,2,1635,1574,3,61,1
61,2,1425,1589,2,164,0
84,0,1589,1606,4,17,0
102,2,1570,1600,11,30,0
62,1,1600,1636,5,36,1
111,0,1783,1595,3,188,0
89,2,1583,1622,4,39,0
37,2,1370,1600,4,230,0
49,2,1593,1503,3,90,1
38,2,1573,1604,4,31,0
19,2,1596,1502,5,94,1
33,2,1500,1605,4,105,0
112,1,1635,1593,3,42,0
12,2,1625,1603,3,22,1
54,1,1610,1750,13,140,1
53,2,1606,1620,11,14,0
71,2,1610,1606,10,4,1
73,2,1599,1609,10,10,0
56,1,1616,1588,7,28,0
50,2,1577,1594,8,17,0
92,1,1712,1563,3,149,0
41,2,1552,1567,7,15,0
57,2,1540,1579,4,39,0
64,1,1528,1530,3,2,1
41,2,1504,1541,7,37,0
56,1,1552,1530,2,22,0
50,1,1543,1456,4,87,0
55,2,1528,1708,4,180,0
33,2,1532,1538,4,6,0
41,2,1491,1541,2,50,0
56,1,1453,1533,3,80,1
65,2,1527,1381,5,146,1
38,1,1535,1602,9,67,1
154,0,1554,1535,11,19,0
8,1,1576,1636,5,60,1
8,1,1593,1348,3,245,0
70,1,1606,1531,3,75,0
72,1,1615,1678,2,63,1
59,2,1675,1624,6,51,1
88,1,1635,1625,5,10,0
77,2,1625,1619,2,6,1
87,2,1612,1680,3,68,0
38,1,1620,1709,2,89,1
50,1,1637,1408,5,229,0
40,1,1636,1614,2,22,0
30,1,1620,1817,4,197,1
63,2,1588,1632,4,44,0
71,2,1619,1644,4,25,0
125,1,1653,1716,3,63,1
21,2,1783,1660,5,123,1
79,2,1806,1667,6,139,1
39,2,1667,1352,4,315,1
88,1,1751,1744,2,7,0
55,2,1711,1757,6,46,0
88,1,1768,1743,3,25,0
75,0,1766,1852,9,86,0
67,2,1581,1798,5,217,0
19,2,1572,1454,2,118,1
44,1,1606,1571,4,35,0
53,2,1563,1462,5,101,1
24,1,1468,1553,4,85,1
90,1,1562,1651,7,89,1
14,1,1570,1705,6,135,1
13,1,913,1058,4,145,1
39,2,1154,920,2,234,1
40,2,1417,921,2,496,1
58,1,930,1099,2,169,1
19,2,1208,936,2,272,1
21,1,944,1151,7,207,1
14,1,948,1271,6,323,1
45,1,951,1367,7,416,1
24,2,1200,958,3,242,1
3,2,815,982,3,167,0
27,1,999,967,4,32,0
7,2,1470,1001,3,469,1
49,2,967,1491,5,524,0
23,2,1490,969,2,521,1
28,1,976,1226,6,250,1
9,2,1240,982,3,258,1
37,2,1421,985,4,436,1
48,1,985,1172,2,187,1
25,2,1172,985,2,187,1
20,2,1299,991,3,308,1
69,2,967,1078,3,111,0
53,2,1427,970,7,457,1
62,1,1289,1732,3,443,1
55,2,1940,1738,3,202,1
102,1,1927,1718,3,209,0
57,2,1706,1700,5,6,1
41,2,1696,1623,5,73,1
41,2,1906,1702,3,204,1
123,2,1694,1545,3,149,1
73,2,1685,1579,4,106,1
45,2,1957,1688,6,269,1
75,2,1922,1693,8,229,1
77,2,1692,1219,4,473,1
123,2,1840,1699,7,141,1
88,1,1720,1383,6,337,0
75,2,1716,1732,5,16,0
36,1,1754,1263,2,491,0
45,2,2021,1759,5,262,1
97,2,1740,1920,10,180,0
85,2,1695,1754,8,59,0
41,2,1735,1929,10,194,0
22,1,1615,1727,3,112,1
48,1,1731,1978,14,247,1
61,2,1905,1738,5,167,1
74,2,1731,1560,4,171,1
41,2,1721,1661,6,60,1
101,2,1912,1713,3,199,1
99,2,1898,1719,11,179,1
50,1,1724,1958,14,234,1
44,1,1599,1716,2,117,1
59,2,1707,1586,3,121,1
72,1,1725,1457,4,268,0
97,0,1717,1985,4,268,0
37,2,1757,1728,4,29,1
95,2,1724,1438,4,286,1
50,1,1728,2027,4,299,1
49,2,1841,1737,8,104,1
40,1,1748,1764,7,16,1
73,2,1321,1771,5,450,0
39,2,1770,1249,5,521,1
60,1,1334,1768,7,434,1
108,1,1426,1764,3,338,1
39,2,1761,1415,9,346,1
24,2,1387,1546,5,159,0
27,2,1542,1284,3,258,1
80,1,1346,1536,1,190,1
33,2,1529,1500,2,29,1
21,2,1981,1109,3,872,1
71,2,1451,1135,5,316,1
64,1,1143,1718,1,575,1
17,2,1233,1257,2,24,0
67,1,1470,1257,4,213,0
10,0,1414,1159,4,255,0
76,1,1500,1250,1,250,0
57,2,1073,1242,8,169,0
43,2,2334,1346,3,988,1
76,2,1364,1500,3,136,0
76,1,1500,1500,6,0,0
118,1,1500,1500,8,0,0
137,2,1337,1662,1,325,0
59,2,1500,1500,3,0,0
8,2,2077,1629,7,448,1
115,0,1304,1287,3,17,0
96,1,1317,1246,3,71,0
66,1,1277,1307,5,30,1
123,2,1296,1315,3,19,0
89,2,1267,1307,5,40,0
74,1,1344,1294,2,50,0
60,1,1307,1218,1,89,0
57,2,1295,1304,1,9,0
61,2,1327,1305,1,22,1
64,1,1235,1296,1,61,1
119,2,1449,1331,4,118,1
69,2,1557,1466,4,91,1
69,2,1849,1903,2,54,0
25,2,1816,1820,4,4,0
62,1,1801,1778,3,23,0
45,2,1734,1784,2,50,0
49,2,1696,1652,2,44,1
36,2,1640,1692,1,52,0
89,2,1581,1601,3,20,0
45,2,1539,1500,5,39,1
57,2,1421,1696,3,275,0
79,2,1317,1423,3,106,0
56,1,1369,1542,4,173,1
22,1,1465,1533,12,68,1
143,0,1500,1429,5,71,0
114,1,1715,1726,5,11,1
110,1,1679,1705,7,26,1
125,2,1692,1730,5,38,0
115,0,1817,1688,7,129,0
31,2,1662,1701,4,39,0
80,1,1711,1759,2,48,1
7,2,1858,1718,4,140,1
88,1,1605,1710,5,105,1
70,1,1716,1886,5,170,1
34,1,1252,1714,3,462,1
78,1,1703,1703,1,0,0
99,2,1700,1715,13,15,0
143,2,1705,1655,10,50,1
74,1,1712,1848,4,136,1
64,1,1652,1702,2,50,1
139,2,1701,1621,8,80,1
53,2,1359,1342,8,17,1
55,2,1640,1346,7,294,1
66,1,1360,1330,7,30,0
40,1,1374,1351,4,23,0
50,2,1362,1312,3,50,1
56,1,1323,1350,3,27,1
74,1,1320,1336,9,16,1
86,1,1336,1292,5,44,0
55,1,1354,1252,8,102,0
31,1,1361,1555,5,194,1
5,0,1357,1471,3,114,0
31,2,1423,1357,3,66,1
63,2,1343,1326,9,17,1
61,2,1330,1278,4,52,1
75,2,1425,1342,8,83,1
60,1,1364,1192,2,172,0
54,1,1199,1355,6,156,1
101,2,1314,1295,6,19,1
45,2,1276,1333,4,57,0
90,1,1351,1332,5,19,0
49,2,1342,1145,4,197,1
58,2,1322,1340,5,18,0
121,0,1107,1332,8,225,0
31,2,2109,1659,5,450,1
118,1,2057,2093,4,36,1
70,1,1839,2085,2,246,1
27,2,2084,1517,9,567,1
76,1,2054,2066,4,12,1
12,1,2093,1932,8,161,0
38,1,2093,1711,3,382,0
101,2,2093,1806,8,287,1
98,1,1743,2088,3,345,1
39,2,2084,1721,11,363,1
2,1,1500,1382,2,118,0
26,1,1172,1500,3,328,1
52,1,1561,1496,9,65,0
37,2,1614,1571,7,43,1
108,1,1445,1564,2,119,1
55,2,1556,1453,3,103,1
86,1,1567,1550,9,17,0
33,2,1671,1575,7,96,1
70,1,1584,1669,7,85,1
41,2,1580,1283,8,297,1
50,0,1580,1958,6,378,0
32,1,1710,1580,2,130,0
52,2,1500,1589,8,89,0
84,1,1580,1578,8,2,0
41,2,1693,1586,2,107,1
29,0,1584,1648,7,64,0
40,2,1575,1545,5,30,1
65,1,1587,1568,6,19,0
72,1,1514,1578,2,64,1
31,2,1545,1590,2,45,0
50,1,1581,1596,8,15,1
23,2,1562,1605,8,43,0
46,1,1389,1555,3,166,1
40,1,1555,1256,6,299,0
29,2,1256,1555,8,299,0
33,2,1555,1256,5,299,1
45,2,1545,1550,5,5,0
116,1,1622,1531,5,91,0
30,1,1514,1524,8,10,1
56,1,1524,2243,5,719,1
24,1,1320,1524,8,204,1
60,2,1524,1565,8,41,0
67,2,1524,1422,5,102,1
47,2,1523,1524,8,1,0
30,1,1567,1518,6,49,0
35,2,1470,1531,9,61,0
120,1,1538,1652,5,114,1
47,1,1505,1542,13,37,1
91,2,1479,1344,2,135,1
41,2,1329,1494,1,165,0
70,1,1505,1510,4,5,1
70,1,1478,1495,2,17,1
74,1,1504,1531,4,27,1
35,2,1511,1526,3,15,0
82,2,1519,1410,3,109,1
41,2,1526,1529,5,3,0
51,2,1519,1495,2,24,1
64,1,1406,1512,10,106,1
123,2,1501,1496,4,5,1
66,1,1480,1491,3,11,1
20,1,1418,1482,4,64,1
79,2,1470,1521,6,51,0
58,1,1376,1462,5,86,1
59,2,1453,1385,4,68,1
126,1,1447,1485,3,38,1
30,1,1324,1440,9,116,1
44,1,1418,1432,6,14,1
31,2,1434,1357,3,77,1
33,1,1444,1475,2,31,1
102,1,1465,1432,5,33,0
29,2,1373,1445,6,72,0
109,2,1434,1442,3,8,0
27,2,1521,1434,17,87,1
28,2,1461,1444,5,17,1
38,2,1480,1462,6,18,1
52,1,1472,1468,3,4,0
83,2,1462,1465,3,3,0
161,0,1459,1462,2,3,0
67,2,1449,1529,5,80,0
57,2,1460,1460,7,0,0
73,2,1501,1481,4,20,1
31,1,1508,1469,8,39,0
46,2,1460,1402,4,58,1
77,2,1450,1442,4,8,1
11,2,1439,1454,2,15,0
30,1,1401,1429,3,28,1
53,2,1413,1333,4,80,1
84,1,2118,1817,8,301,0
171,2,2118,2197,10,79,0
39,2,2118,2004,4,114,1
96,1,2078,2077,13,1,0
29,2,2040,1969,10,71,1
41,2,2032,1585,7,447,1
77,2,1938,1862,7,76,1
31,2,1862,1871,7,9,0
140,1,1697,1794,16,97,1
15,2,1655,1709,5,54,0
23,2,1500,1451,4,49,1
21,2,1500,1500,3,0,0
44,1,1671,1500,4,171,0
111,1,1671,1567,2,104,0
30,2,1710,1671,1,39,1
39,1,1610,1671,5,61,1
52,1,1671,1743,6,72,1
15,2,1671,1398,6,273,1
23,2,1398,1671,5,273,0
64,1,1671,2014,4,343,1
59,2,1794,1671,6,123,1
45,2,1771,1671,6,100,1
131,2,1648,1682,3,34,0
136,1,1692,1735,4,43,1
13,2,1688,1421,3,267,1
60,1,1705,1676,5,29,0
34,1,1396,1672,8,276,1
43,2,1667,1456,5,211,1
46,1,1684,1435,4,249,0
40,1,1549,1676,5,127,1
37,1,1687,1668,5,19,0
72,1,1698,1680,10,18,0
55,2,1698,1470,4,228,1
50,1,1470,1698,3,228,1
87,2,1689,1616,12,73,1
32,1,1673,1678,11,5,1
53,2,1670,1588,6,82,1
109,2,1791,1677,2,114,1
143,0,1639,1663,2,24,0
37,2,1650,1720,5,70,0
27,2,1790,1657,6,133,1
41,2,1646,1640,6,6,1
43,2,1856,1651,4,205,1
73,2,1655,1662,13,7,0
53,2,1646,1673,6,27,0
73,2,1662,1656,8,6,1
67,2,1516,1506,5,10,1
38,1,1489,1501,4,12,1
26,1,1188,1501,2,313,1
62,1,1999,1929,2,70,0
48,1,1901,1718,5,183,0
34,1,1587,1500,3,87,0
26,1,1891,1500,4,391,0
72,1,1829,1707,2,122,0
93,0,1736,1832,3,96,0
62,1,1847,1712,2,135,0
82,1,1834,1835,7,1,1
129,2,1825,1769,2,56,1
96,0,1864,1823,10,41,0
145,0,1964,1818,10,146,0
78,1,1834,1723,2,111,0
36,1,1727,1825,3,98,1
36,1,1701,1816,13,115,1
35,2,1807,1690,4,117,1
112,1,1650,1800,3,150,1
29,2,1791,1683,2,108,1
28,1,1705,1781,4,76,1
66,1,1697,1770,10,73,1
73,0,1770,1774,11,4,0
106,1,1811,1755,2,56,0
30,1,1768,1754,5,14,0
33,2,1678,1785,5,107,0
32,1,1798,1764,7,34,0
65,2,1759,1814,8,55,0
52,1,1827,1829,5,2,1
71,2,1799,1843,13,44,0
52,1,1848,2122,8,274,1
13,0,1849,1826,5,23,0
30,1,1994,2023,9,29,1
43,2,2011,2004,5,7,1
119,2,1895,2028,4,133,0
36,1,1989,2016,6,27,1
89,2,2177,2024,5,153,1
58,2,2009,2058,7,49,0
21,2,2003,1774,4,229,1
116,1,1984,1990,2,6,1
136,1,1910,1979,8,69,1
126,1,2173,1979,4,194,0
16,1,1811,1753,7,58,0
44,1,1824,1798,6,26,0
32,1,1834,1896,3,62,1
50,1,1495,1831,8,336,1
30,1,1840,1914,8,74,1
55,2,1874,1851,6,23,1
74,1,1889,1837,3,52,0
98,1,1305,1402,3,97,1
150,1,1500,1402,2,98,0
86,1,1406,1823,9,417,1
29,2,1379,1421,5,42,0
83,2,1366,1171,4,195,1
68,1,1366,1500,2,134,1
38,1,1368,1918,13,550,1
36,1,1689,1273,11,416,0
75,0,1721,1249,9,472,0
39,2,1114,1286,3,172,0
41,2,1585,1295,4,290,1
35,2,1638,1303,4,335,1
80,1,1311,1623,7,312,1
52,1,1302,1278,3,24,0
57,2,1432,1298,1,134,1
24,1,1300,1912,4,612,1
55,2,2012,2074,7,62,0
118,1,2017,2232,2,215,1
54,1,2027,2079,11,52,1
67,2,2018,1923,8,95,1
50,1,1915,2009,7,94,1
91,2,2003,1808,5,195,1
62,1,2063,1500,6,563,0
27,2,1681,1500,5,181,1
110,1,1500,1493,3,7,0
116,1,1500,1723,3,223,1
75,2,1723,1500,2,223,1
80,1,1500,1723,1,223,1
100,1,1500,1723,3,223,1
81,2,1723,1500,3,223,1
98,1,1500,1723,2,223,1
98,1,1500,1723,3,223,1
63,2,1723,1500,2,223,1
115,2,1723,1500,4,223,1
46,1,1534,1415,7,119,0
56,1,1433,1597,3,164,1
102,1,1462,1715,4,253,1
43,2,1561,1493,7,68,1
16,2,1550,1532,4,18,1
99,2,1745,1556,9,189,1
76,1,1623,1487,4,136,0
15,2,1485,1557,2,72,0
54,1,1638,1574,8,64,0
89,2,1532,1773,8,241,0
25,2,1720,1538,6,182,1
58,1,1247,1702,9,455,1
37,2,1635,1432,3,203,1
45,2,1500,1404,8,96,1
27,1,1500,1730,3,230,1
91,2,1542,1500,4,42,1
3,2,1047,1500,3,453,0
29,2,1293,1234,4,59,1
31,2,1367,1346,4,21,1
27,2,1543,1500,2,43,1
59,2,1354,1347,5,7,1
58,1,1094,1334,6,240,1
86,1,1370,1327,4,43,0
49,2,1399,1273,3,126,1
54,1,1278,1488,3,210,1
67,2,1267,1233,5,34,1
33,2,1500,1267,5,233,1
53,2,1287,1278,3,9,1
91,2,1263,1343,3,80,0
30,1,1271,1349,2,78,1
57,2,1460,1277,3,183,1
66,1,1292,1330,5,38,1
78,1,1292,1500,6,208,1
62,1,1303,1319,2,16,1
75,2,1307,1314,2,7,0
75,2,1301,1318,4,17,0
56,1,1301,1385,5,84,1
66,1,1978,1916,7,62,0
80,1,1977,2241,6,264,1
31,2,2064,1986,5,78,1
45,2,1935,1999,5,64,0
35,2,1997,1631,4,366,1
37,2,1842,2013,4,171,0
45,2,2011,1602,8,409,1
60,1,1734,2007,4,273,1
51,2,1998,1891,8,107,1
80,1,1688,1995,4,307,1
58,1,2011,1828,7,183,0
91,2,2006,1757,12,249,1
50,1,2052,1992,12,60,0
55,2,1979,2008,10,29,0
47,2,1977,1564,5,413,1
124,1,1712,1973,12,261,1
35,2,1962,1935,8,27,1
145,2,1936,1938,10,2,0
118,1,1953,1770,6,183,0
58,1,1775,1946,3,171,1
39,2,1939,1781,5,158,1
196,1,1954,1850,3,104,0
126,1,1858,1944,9,86,1
104,0,1542,1954,4,412,0
37,2,1952,1507,2,445,1
62,1,1801,1945,5,144,1
27,2,1932,1948,11,16,0
56,1,1509,1930,2,421,1
84,1,1939,2008,11,69,1
109,1,1728,1933,4,205,1
51,2,1928,1688,10,240,1
42,1,1663,1924,4,261,1
29,2,1913,1874,8,39,1
53,2,1912,1339,3,573,1
78,1,1480,1910,5,430,1
106,1,1905,1898,5,7,0
66,1,1907,1886,5,21,0
73,2,1872,1919,8,47,0
61,2,1858,1932,4,74,0
76,1,1515,1855,1,340,1
79,2,1852,1518,3,334,1
25,2,1788,1626,5,162,1
104,1,1804,1869,7,65,1
69,2,1802,1367,5,435,1
69,2,1973,1808,2,165,1
33,2,1803,1562,4,241,1
30,1,1431,1800,1,369,1
103,2,1384,1821,1,437,0
96,1,1847,1762,2,85,0
32,1,1732,1839,6,107,1
66,1,1591,1834,3,243,1
109,2,1896,1843,6,53,1
118,1,1620,1838,4,218,1
101,2,1832,1626,7,206,1
82,1,1631,1826,7,195,1
93,2,1819,1637,4,182,1
52,1,1607,1813,6,206,1
54,1,1359,1806,1,447,1
150,1,1513,1802,3,289,1
107,2,1798,1517,4,281,1
63,2,1796,1388,3,408,1
91,2,1788,1665,3,123,1
70,1,1954,1771,4,183,0
151,2,1759,1767,4,8,0
131,0,1913,1754,7,159,0
55,2,1517,1772,6,255,0
81,2,2150,1774,5,376,1
50,1,1641,1766,6,125,1
39,2,1758,1649,8,109,1
66,1,1754,1746,3,8,0
77,2,1737,1674,5,63,1
68,1,1750,1660,5,90,0
98,1,1476,1746,4,270,1
75,2,1733,1783,4,50,0
83,2,1688,1745,3,57,0
41,2,1737,1637,4,100,1
25,2,1953,1500,5,453,1
57,2,1856,1953,9,97,0
45,2,1836,1953,3,117,0
156,1,1372,1953,10,581,1
40,1,1895,1953,10,58,1
41,2,1887,1905,9,18,0
38,1,1621,1855,6,234,1
35,2,1823,1554,6,269,1
40,1,1569,1775,6,206,1
64,1,1540,1703,13,163,1
47,2,1500,1549,8,49,0
79,2,946,1069,3,123,0
3,2,1102,1069,2,33,1
49,2,1500,1500,2,0,0
70,1,1200,1200,4,0,0
87,2,1200,1200,3,0,0
14,1,1209,1160,3,49,0
31,2,1424,1280,1,144,1
22,1,1500,1415,2,85,0
37,2,1379,1431,4,52,0
73,2,1724,1500,5,224,1
7,2,1286,1225,1,61,1
42,1,1797,2199,1,402,1
64,1,1799,2196,1,397,1
56,1,1750,2195,2,445,1
57,2,2191,1884,2,307,1
38,1,1887,2187,9,300,1
65,2,2184,1891,2,293,1
88,1,2167,2172,3,5,1
54,1,1321,1946,6,625,1
126,1,1718,1941,2,223,1
115,2,1932,1831,5,101,1
114,1,1233,1932,4,699,1
94,1,1945,1901,5,44,0
82,1,1951,2109,11,158,1
69,2,1938,1985,8,47,0
41,2,1938,1527,14,411,1
65,2,1865,1953,2,88,0
113,0,1956,1862,11,94,0
94,1,1828,1948,10,120,1
38,1,1964,1813,7,151,0
30,2,1955,1890,8,65,1
169,2,1784,1972,8,188,0
126,1,1929,2106,5,177,1
114,1,1965,2077,7,112,1
45,2,2043,1981,5,62,1
65,2,1966,2056,5,90,0
47,2,1334,1428,4,94,0
41,2,1603,1339,4,264,1
37,2,1719,1341,5,378,1
105,2,1519,1348,5,171,1
29,2,1667,1361,3,306,1
105,2,1668,1365,3,303,1
94,1,1518,1345,6,173,0
98,1,1349,1653,3,304,1
70,1,1065,1344,4,279,1
61,1,1627,1321,5,306,0
104,1,1325,1617,4,292,1
51,2,1694,1329,7,365,1
60,1,1334,1572,6,238,1
56,1,1336,1786,6,450,1
97,2,1596,1341,3,255,1
63,2,1323,1449,4,126,0
65,2,1829,1324,5,505,1
75,2,1537,1330,4,207,1
122,1,1393,1314,5,79,0
61,2,1480,1322,5,158,1
51,2,1676,1325,2,351,1
99,2,1301,1697,4,396,0
57,1,1305,1611,11,306,1
52,1,1671,1668,2,3,0
44,2,2586,1618,17,968,1
52,1,1204,1083,1,121,0
49,2,1903,1390,6,513,1
23,1,1387,1390,3,3,1
20,1,1400,1439,4,39,1
35,2,1428,1411,3,17,1
93,2,1398,1445,5,47,0
22,1,1410,1337,5,73,0
64,1,1421,1429,4,8,1
130,1,1435,1383,4,52,0
121,2,1420,1471,5,51,0
45,2,1445,1431,6,14,1
148,1,1312,1422,5,110,1
77,2,1412,1321,5,91,1
66,1,1331,1401,7,70,1
51,2,1390,1386,4,4,1
130,1,1401,1430,3,29,1
50,1,1283,1392,3,109,1
48,1,1381,1377,7,4,0
25,2,1362,1392,8,30,0
18,1,1380,1252,9,128,0
56,1,1288,1368,8,80,1
107,2,1355,1302,6,53,1
43,2,1345,1235,9,110,1
62,1,1407,1326,4,81,0
91,2,1282,1451,7,169,0
23,2,1269,1205,4,64,1
60,1,1274,1570,4,296,1
50,1,1279,1576,2,297,1
75,2,1569,1284,1,285,1
71,2,1850,1285,6,565,1
75,2,1751,1287,4,464,1
132,1,1288,1952,4,664,1
46,1,1289,1825,3,536,1
17,2,1430,1274,5,156,1
33,2,1250,1439,4,189,0
117,2,1230,1297,4,67,0
52,1,1243,1314,4,71,1
30,1,1953,1721,9,232,0
15,2,1340,1203,5,137,1
115,2,1365,1301,2,64,1
38,1,1493,1301,6,192,0
52,1,1301,1571,2,270,1
61,2,1571,1301,4,270,1
49,2,1301,1571,3,270,0
81,2,1571,1301,3,270,1
54,1,1500,1301,4,199,0
48,1,1500,1455,1,45,0
57,2,1791,1500,5,291,1
31,1,1500,1791,2,291,1
33,2,1791,1500,4,291,1
64,1,1629,2195,2,566,1
44,1,2195,2028,12,167,0
86,1,1822,2192,1,370,1
60,1,2218,1990,7,228,0
94,1,1795,2215,3,420,1
119,2,2202,2008,5,194,1
25,2,2199,1802,7,397,1
39,2,2198,1500,3,698,1
76,1,1555,2197,4,642,1
56,1,1787,2194,3,407,1
50,1,1467,2194,1,727,1
46,2,2189,1868,5,321,1
72,1,1897,2183,4,286,1
101,2,2183,1551,7,632,1
36,1,1775,2179,6,404,1
43,2,1718,2210,4,492,0
39,2,2204,1967,6,237,1
54,1,1915,2198,9,283,1
89,2,1949,2225,6,276,0
83,2,2222,1842,2,380,1
7,2,2222,1382,4,840,1
44,1,1299,2221,6,922,1
34,2,1954,2249,3,295,0
52,1,2279,1826,2,453,0
66,1,2063,2271,2,208,1
49,2,2270,1613,3,657,1
3,2,2269,1672,3,597,1
50,1,1835,2266,6,431,1
122,0,2277,1893,7,384,0
70,1,2088,2269,7,181,1
7,2,2262,2037,7,225,1
74,1,1915,2258,5,343,1
54,2,2251,2006,7,245,1
88,1,2106,2241,6,135,1
49,2,2229,2134,5,95,1
28,1,1820,2225,3,405,1
37,2,2222,1810,5,412,1
40,1,1622,2212,2,590,1
81,2,2090,2236,6,146,0
80,1,1275,1253,2,22,0
2,2,1049,1275,1,226,0
49,2,1527,1341,3,186,1
13,2,1535,1500,3,35,1
45,2,2177,1686,4,491,1
62,1,1748,1855,8,107,1
94,1,1759,1500,10,259,0
71,2,1516,1508,6,8,1
94,0,1500,1516,4,16,0
63,2,1535,1528,7,7,1
104,1,1537,1662,4,125,1
69,2,1519,1650,6,131,0
35,2,1662,1528,6,134,1
58,1,1360,1522,3,162,1
72,1,1542,1213,4,329,0
30,1,1081,1356,1,275,1
37,2,1351,1116,3,235,1
44,1,1167,1346,6,179,1
31,2,1338,1264,5,74,1
3,2,2053,1264,3,789,1
56,1,1264,1358,5,94,1
34,1,1264,1065,3,199,0
61,2,1065,1264,3,199,0
43,2,1395,1500,3,105,0
55,2,1579,1500,2,79,1
40,1,1161,1389,4,228,1
34,2,1373,1518,2,145,0
48,2,1375,1385,3,10,0
40,1,1397,1363,3,34,0
61,2,1624,1402,4,222,1
104,1,1328,1393,1,65,1
141,2,1385,1274,3,111,1
40,1,1397,1368,3,29,0
85,2,1628,1402,3,226,1
63,2,1597,1407,4,190,1
57,2,1401,1626,2,225,0
57,1,1411,1422,2,11,1
47,2,1485,1420,4,65,1
38,1,1336,1412,4,76,1
41,2,1434,1422,5,12,1
58,1,1422,1500,2,78,1
27,2,1645,1437,5,208,1
98,1,1446,1489,3,43,1
33,1,1246,1441,1,195,1
99,2,1429,1467,4,38,0
57,2,1417,1446,3,29,0
2,1,1430,1366,2,64,0
159,0,1455,1510,3,55,0
29,2,1500,1465,4,35,1
48,1,1494,1447,4,47,0
85,2,1433,1558,4,125,0
53,2,1515,1441,4,74,1
64,1,1274,1435,4,161,1
165,2,2104,1818,3,286,1
103,2,1382,1389,4,7,0
67,2,1606,1382,7,224,1
76,1,1382,1552,5,170,1
115,2,1412,1382,11,30,1
110,1,1311,1382,6,71,1
68,1,1393,1415,8,22,1
26,1,1500,1393,4,107,0
59,2,1270,1408,3,138,0
84,1,1423,1396,4,27,0
44,1,1396,1485,4,89,1
38,2,1521,1403,7,118,1
75,0,1401,1477,6,76,0
40,1,943,1013,7,70,1
55,1,1062,923,3,139,0
33,2,1369,1074,2,295,1
68,1,1486,994,2,492,0
67,2,1698,994,3,704,1
60,2,971,1046,3,75,0
54,1,1159,911,3,248,0
86,0,1710,1741,6,31,0
57,1,1648,1707,7,59,1
82,1,1769,1639,6,130,0
46,1,1619,1483,3,136,0
30,1,1147,1087,3,60,0
43,2,991,1084,7,93,0
68,1,1257,991,3,266,0
17,2,991,1257,4,266,0
115,0,1257,991,6,266,0
63,2,991,1257,1,266,0
78,1,1257,991,5,266,0
25,2,2347,1906,8,441,1
51,2,2344,1898,4,446,1
45,2,2333,2134,12,199,1
22,1,2010,2327,13,317,1
42,2,2320,2013,11,307,1
39,1,1912,2316,2,404,1
57,2,2311,1917,11,394,1
59,2,2298,2146,8,152,1
72,1,2052,2287,13,235,1
54,2,2276,2057,16,219,1
45,2,2270,1908,9,362,1
43,2,2260,2005,4,255,1
87,2,2248,2015,10,233,1
63,2,2235,2010,6,225,1
128,2,2214,2112,4,102,1
41,2,2191,2077,7,114,1
110,1,2191,2277,9,86,1
29,2,2067,2243,6,176,0
107,0,2243,2186,14,57,0
30,1,2186,2243,10,57,1
29,2,2223,2032,7,191,1
51,2,2208,1944,15,264,1
50,1,2055,2179,11,124,1
119,0,2052,2162,4,110,0
26,1,2270,1974,8,296,0
84,1,1978,2245,11,267,1
77,2,2210,1982,5,228,1
57,2,2210,1943,6,267,1
60,2,2185,1851,8,334,1
23,2,2094,2041,7,53,1
59,2,1874,2049,4,175,0
51,2,1500,1793,4,293,0
75,2,1608,1794,6,186,0
103,2,1608,1500,3,108,1
14,1,1500,1608,3,108,1
23,2,1608,1500,2,108,1
12,1,1500,1608,1,108,1
117,2,1795,1811,8,16,0
66,2,1832,1805,9,27,1
35,2,1794,1784,4,10,1
82,1,1803,1859,4,56,1
38,2,1794,1750,7,44,1
70,1,1784,1784,2,0,0
61,2,1773,1785,5,12,0
55,2,1877,1781,10,96,1
122,1,1807,1769,2,38,0
94,1,1777,1853,2,76,1
123,2,1765,1841,5,76,0
125,2,1832,1773,3,59,1
65,2,1762,1789,9,27,0
85,2,1778,1773,8,5,1
64,1,1783,1779,5,4,0
115,2,1773,1751,3,22,1
109,2,1761,1808,7,47,0
20,1,1801,1749,8,52,0
50,1,1746,1739,5,7,0
69,2,1729,1706,5,23,1
95,2,1742,1739,5,3,1
77,2,1713,1809,8,96,0
49,2,1699,1803,4,104,0
51,2,1795,1707,3,88,1
56,1,1716,1768,3,52,1
91,2,1734,1727,11,7,1
56,1,1735,1794,6,59,1
80,1,1746,1729,6,17,0
79,1,1758,1718,2,40,0
83,2,1704,1770,2,66,0
45,2,1798,1780,2,18,1
95,2,1755,1792,7,37,0
152,1,1804,1752,4,52,0
71,2,1795,1712,10,83,1
81,2,1279,1693,7,414,0
64,1,1693,1279,4,414,0
94,1,1486,1688,4,202,1
83,2,1676,1669,3,7,1
23,2,2199,1677,8,522,1
82,1,1694,1520,5,174,0
67,2,1678,1839,4,161,0
107,2,1791,1380,6,411,1
30,2,1874,1381,4,493,1
96,1,1411,1177,8,234,0
69,2,1295,1427,3,132,0
12,2,1418,1302,5,116,1
95,2,1397,1643,4,246,0
41,2,1374,1687,4,313,0
33,2,1685,1387,4,298,1
43,1,1388,2012,9,624,1
31,2,2029,1389,4,640,1
37,1,1389,2297,4,908,1
35,2,1375,1408,4,33,0
101,2,1399,1386,4,13,1
70,1,1766,1386,2,380,0
71,2,1375,1333,2,42,1
54,1,1345,1363,2,18,1
64,1,1239,1372,4,133,1
78,1,1387,1296,4,91,0
51,2,1471,1397,5,74,1
64,1,1397,1766,3,369,1
31,2,1766,1397,2,369,1
49,2,1397,1766,3,369,0
39,2,1382,1406,2,24,0
114,1,1386,1683,10,297,1
15,2,1663,1391,4,272,1
92,1,1396,1638,3,242,1
83,2,1720,1406,5,314,1
61,2,1612,1506,4,106,1
70,1,1506,2221,1,715,1
57,2,1948,1508,3,440,1
83,2,1493,1585,2,92,0
59,2,1480,1508,2,28,0
76,1,1489,1580,2,91,1
119,2,1527,1501,3,26,1
71,2,1459,1515,5,56,0
42,2,1514,1528,8,14,0
43,2,1516,1500,7,16,1
50,1,1517,2061,10,544,1
42,2,1832,1520,4,312,1
43,2,1846,1524,4,322,1
44,1,1530,1484,4,46,0
60,1,1176,1526,4,350,1
26,1,1530,1843,4,313,1
46,1,1538,1662,5,124,1
86,0,2018,1527,5,491,0
99,2,1517,1567,6,50,0
65,2,1502,1590,11,88,0
64,1,1511,1599,1,88,1
49,2,1808,1515,6,293,1
36,2,1772,1520,3,252,1
45,2,1520,1545,6,25,0
36,2,2007,1865,9,142,1
51,2,1919,2021,7,102,0
40,1,2036,1882,4,154,0
62,1,2045,2024,5,21,0
133,2,1816,2041,6,225,0
96,1,2058,1798,7,260,0
46,1,1802,2054,6,252,1
35,2,2050,1807,3,243,1
82,1,2025,2040,6,15,1
140,2,2032,1961,3,71,1
40,1,1838,2026,1,188,1
39,2,2021,1844,5,177,1
45,2,2116,2029,5,87,1
148,1,2044,1867,5,177,0
30,1,1919,2037,6,118,1
73,2,2028,1981,2,47,1
28,2,2018,1988,6,30,1
43,2,2013,1823,5,190,1
20,1,1829,2008,6,179,1
31,1,2039,1996,6,43,0
106,2,1984,2052,10,68,0
65,2,1813,1999,2,186,0
21,2,1989,1987,2,2,1
118,1,1907,1981,6,74,1
19,2,1903,1985,4,82,0
69,2,1979,1800,6,179,1
94,1,1991,1932,4,59,0
87,2,1920,2004,4,84,0
60,1,2041,1992,6,49,0
36,1,2004,1967,4,37,0
132,1,1916,1996,2,80,1
68,1,1996,2132,2,136,1
25,2,2176,2001,6,175,1
65,2,2039,2011,5,28,1
60,1,2017,2167,6,150,1
120,1,1900,2010,1,110,1
78,1,2031,2086,2,55,1
24,1,1901,2024,2,123,1
61,2,1929,2037,4,108,0
55,2,2030,1937,5,93,1
86,1,2017,2020,4,3,1
34,1,2030,2036,9,6,1
58,1,2000,2020,6,20,1
67,2,2011,1978,3,33,1
44,1,1912,2003,2,91,1
75,2,1993,1996,9,3,0
118,0,2111,1981,6,130,0
60,1,1994,1917,5,77,0
67,2,2028,1971,5,57,1
54,1,1997,1500,4,497,0
17,2,1682,1396,11,286,1
19,2,1861,1398,4,463,1
96,1,1788,1399,5,389,0
107,2,1776,1401,10,375,1
16,1,1401,1603,6,202,1
2,1,1401,1612,2,211,1
135,2,1706,1405,3,301,1
72,1,1418,1421,3,3,1
53,2,1408,1432,1,24,0
29,2,1420,1591,7,171,0
52,1,1430,1805,8,375,1
53,2,2022,1431,11,591,1
65,2,1551,1440,12,111,1
65,2,1640,1447,11,193,1
69,2,1783,1450,4,333,1
47,2,1428,1666,11,238,0
37,2,1776,1432,11,344,1
120,1,1629,1410,4,219,0
62,1,1450,1392,1,58,0
65,2,1482,1460,4,22,1
52,1,1442,1449,7,7,1
52,1,1533,1435,6,98,0
57,2,1500,1442,9,58,1
95,1,1450,1532,2,82,1
13,2,1623,1456,8,167,1
153,2,1541,1465,8,76,1
89,2,1655,1470,4,185,1
58,1,1480,1533,2,53,1
30,2,1311,1495,4,184,0
73,2,1485,1474,3,11,1
47,2,1479,1496,4,17,0
63,2,1485,1490,2,5,0
16,1,1479,1573,2,94,1
4,1,1543,1466,4,77,0
76,1,1478,1461,3,17,0
58,1,1488,1490,3,2,1
78,1,1560,1475,6,85,0
56,2,1477,1483,8,6,0
58,1,1492,1553,2,61,1
76,1,1551,1479,6,72,0
116,0,1603,1475,6,128,0
21,2,1500,1482,3,18,1
74,1,1485,1471,4,14,0
128,0,1469,1524,3,55,0
20,0,1376,1472,8,96,0
45,2,1492,1483,6,9,1
67,2,1499,1493,4,6,1
49,2,1482,1483,3,1,0
52,2,1468,1592,3,124,0
79,2,1457,1446,3,11,1
45,2,1449,1377,2,72,1
70,1,1458,1521,2,63,1
40,1,1500,1500,5,0,0
36,2,1002,1412,10,410,0
36,1,1461,1402,8,59,0
62,1,1256,1395,4,139,1
44,1,1370,1372,5,2,1
37,2,1325,1375,5,50,0
96,0,1204,1379,3,175,0
27,2,1429,1389,5,40,1
97,2,1470,1397,3,73,1
75,2,1386,1397,6,11,0
16,1,1393,1539,6,146,1
47,2,1532,1400,6,132,1
63,2,1470,1409,4,61,1
121,2,1524,1416,5,108,1
63,2,1445,1426,2,19,1
77,2,1416,1438,6,22,0
72,0,1359,1440,3,81,0
65,1,1413,1430,4,17,1
58,1,1094,1427,4,333,1
79,1,1269,1421,5,152,1
59,2,1341,1434,5,93,0
88,1,1250,1428,2,178,1
62,1,1417,1417,2,0,0
94,0,1404,1418,3,14,0
16,1,1397,1407,5,10,1
86,0,1463,1405,3,58,0
44,1,1300,1397,6,97,1
56,0,1401,1296,3,105,0
27,2,1319,1414,3,95,0
79,2,1541,1422,4,119,1
55,2,1419,1074,4,345,1
26,1,1081,1416,3,335,1
42,1,1498,1391,1,107,0
85,2,1534,1397,3,137,1
46,1,1417,1386,3,31,0
25,2,1511,1393,10,118,1
39,2,1405,1403,2,2,1
84,1,1319,1395,2,76,1
56,1,1434,1383,2,51,0
32,1,1421,1371,1,50,0
88,1,1383,1360,5,23,0
157,2,1262,1374,1,112,0
48,1,1386,1326,9,60,0
26,1,1054,1373,1,319,1
100,1,1381,1460,3,79,1
56,1,1831,2120,9,289,1
103,2,1943,1839,5,104,1
42,1,1842,2137,3,295,1
80,1,1849,1968,3,119,1
51,2,1960,1857,5,103,1
112,1,1865,1952,7,87,1
44,1,1870,2073,2,203,1
61,2,2022,1877,5,145,1
97,2,1909,1887,5,22,1
159,2,1954,1902,5,52,1
82,1,1913,1925,3,12,1
61,2,1901,1924,3,23,0
59,2,1889,1938,3,49,0
146,1,1950,1876,5,74,0
20,1,1885,1960,2,75,1
119,2,1951,1894,1,57,1
98,1,1891,1912,4,21,1
41,2,2152,1895,5,257,1
58,1,1943,1882,5,61,0
16,1,1993,1868,5,125,0
97,2,1855,1912,3,57,0
35,2,2177,1858,5,319,1
31,2,2092,1863,4,229,1
68,1,1870,1989,2,119,1
65,2,2054,1876,5,178,1
29,2,2026,1883,3,143,1
55,2,2017,1890,3,127,1
60,1,1897,2003,2,106,1
55,2,1995,1905,4,90,1
65,2,1869,1960,3,91,0
50,1,1875,2042,3,167,1
16,1,1884,1932,3,48,1
39,2,1872,1918,2,46,0
40,1,1915,1859,3,56,0
23,2,1906,1869,4,37,1
46,2,2069,1875,4,194,1
71,2,1862,1935,3,73,0
41,2,1937,1870,2,67,1
68,1,1973,1856,3,117,0
155,2,1842,1958,3,116,0
31,2,1276,1486,3,210,0
41,2,1743,1504,5,239,1
90,1,1504,1685,5,181,1
55,2,1685,1504,4,181,1
3,2,1639,1504,3,135,1
21,2,1733,1504,5,229,1
52,1,1556,1588,4,32,1
55,2,1713,1525,6,188,1
74,1,1823,1880,6,57,1
66,1,1739,1713,7,26,0
6,1,1966,1616,6,350,0
44,1,1620,1909,4,289,1
164,1,1829,1500,4,329,0
4,0,1992,1811,2,181,0
39,1,1413,1430,2,17,1
67,2,2430,1413,3,1017,1
31,2,1666,1413,8,253,1
42,2,1477,1413,7,64,1
27,2,1806,1413,2,393,1
24,1,1413,1806,5,393,1
85,2,1388,1413,2,25,0
24,1,1413,1425,3,12,1
31,2,1849,1413,3,436,1
16,1,1413,1336,5,77,0
29,1,1413,1820,2,407,1
50,2,1852,1413,1,439,1
51,2,1861,1413,1,448,1
119,0,1421,1413,2,8,0
68,1,1423,1432,5,9,1
62,1,1431,1516,9,85,1
110,1,1650,1414,3,236,0
49,1,1424,1441,5,17,1
74,2,1563,1431,6,132,1
68,0,1428,1527,3,99,0
39,1,1439,1426,7,13,0
44,1,1587,1423,4,164,0
50,1,1390,1413,2,23,1
8,2,1403,1388,3,15,1
162,1,1600,1387,8,213,0
47,2,1470,1395,5,75,1
55,1,1406,1391,3,15,0
47,2,1379,1418,1,39,0
73,2,1411,1303,3,108,1
105,1,1387,1401,2,14,1
48,1,1411,1404,6,7,0
77,1,1418,1574,5,156,1
38,1,1419,1382,5,37,0
48,1,1429,1432,2,3,1
49,2,1492,1438,2,54,1
35,1,1447,1499,5,52,1
119,2,1436,1472,5,36,0
8,0,1518,1431,2,87,0
141,2,1352,1444,2,92,0
39,2,1441,1464,8,23,0
52,1,1500,1432,3,68,0
107,2,1424,1355,5,69,1
39,2,1441,1500,3,59,0
70,1,1710,1911,2,201,1
48,1,1944,1896,7,48,0
94,1,1944,1928,5,16,0
70,1,1781,1930,3,149,1
51,2,1914,1788,9,126,1
77,2,1892,1831,7,61,1
30,1,1733,1875,8,142,1
58,1,1791,1851,4,60,1
28,1,1940,1808,12,132,0
76,2,1774,1772,2,2,1
52,1,1850,1905,5,55,1
61,2,2041,1876,4,165,1
85,2,1329,1876,3,547,0
40,1,1670,1848,5,178,1
33,2,1814,1661,4,153,1
94,1,1884,1827,7,57,0
3,0,1880,1886,3,6,0
93,2,1857,1537,3,320,1
64,1,1541,1817,3,276,1
77,2,1662,1692,10,30,0
48,1,1500,1500,2,0,0
3,0,1563,1396,3,167,0
61,2,1835,1396,7,439,1
27,2,1329,1061,4,268,1
60,1,1067,1263,6,196,1
115,2,1392,1500,3,108,0
68,1,1000,999,4,1,0
92,1,1006,1399,5,393,1
91,2,1404,1013,2,391,1
74,1,1015,1563,5,548,1
51,1,1015,1200,5,185,1
81,2,1619,1017,7,602,1
90,1,1020,1618,5,598,1
37,2,1617,1022,4,595,1
76,2,1173,1022,2,151,1
43,2,1169,1448,1,279,0
37,2,1152,1471,5,319,0
60,1,1494,1215,4,279,0
77,2,1194,1519,2,325,0
35,2,1513,1273,4,240,1
92,1,1240,1507,2,267,1
43,2,1504,1139,1,365,1
80,1,1148,1500,1,352,1
105,2,1497,1113,2,384,1
45,2,1494,1116,11,378,1
39,2,1283,1516,7,233,0
73,2,1513,1156,1,357,1
59,2,1507,1248,1,259,1
53,2,1502,1227,1,275,1
23,2,1498,1147,1,351,1
44,1,1248,1492,2,244,1
49,2,1485,1298,1,187,1
63,2,1500,1329,3,171,1
48,1,1382,1644,1,262,1
27,2,1638,1500,3,138,1
58,1,1611,1839,6,228,1
74,1,1622,1694,11,72,1
24,2,1941,1626,10,315,1
25,2,1795,1635,6,160,1
71,1,1642,1847,2,205,1
59,2,1900,1647,9,253,1
42,1,1649,2183,8,534,1
90,1,1651,2068,13,417,1
28,1,1668,1808,6,140,1
89,2,1855,1675,3,180,1
36,2,2240,1677,8,563,1
73,1,1678,2205,9,527,1
33,1,1679,2293,19,614,1
24,2,1921,1685,4,236,1
32,0,1674,2022,7,348,0
68,2,1966,1679,11,287,1
65,2,2105,1681,10,424,1
60,2,1886,1688,7,198,1
47,1,1690,2172,10,482,1
49,2,2121,1693,11,428,1
53,2,1918,1699,5,219,1
51,1,1703,2021,8,318,1
56,1,1707,2021,5,314,1
82,2,2021,1711,7,310,1
29,2,1694,1838,16,144,0
102,1,1906,1672,8,234,0
94,1,1673,2300,17,627,1
25,2,2037,1677,7,360,1
26,2,1920,1682,8,238,1
60,1,1688,1935,8,247,1
71,1,1896,1644,7,252,0
41,2,1870,1650,7,220,1
52,2,1860,1657,4,203,1
58,2,1786,1665,9,121,1
19,2,2134,1667,8,467,1
66,0,1660,1852,9,192,0
40,1,1793,1640,7,153,0
75,1,1865,1617,18,248,0
56,1,1601,1943,6,342,1
48,1,1603,2001,13,398,1
50,2,1946,1607,7,339,1
40,1,1612,1891,5,279,1
34,2,1808,1619,7,189,1
37,1,1624,1864,3,240,1
59,2,1922,1629,7,293,1
73,2,1841,1636,7,205,1
41,2,1696,1702,7,6,0
112,1,1642,1585,2,57,0
56,1,1765,1622,7,143,0
64,1,1649,1500,2,149,0
89,2,1138,1104,1,34,1
74,1,1135,1125,2,10,0
32,1,1157,1264,3,107,1
31,2,1126,1094,2,32,1
87,2,1328,1146,2,182,1
79,2,1681,1150,3,531,1
114,1,1154,1679,6,525,1
37,2,1165,1127,7,38,1
102,1,1188,1415,4,227,1
82,1,1096,1135,5,39,1
50,1,1135,1709,2,574,1
110,0,2186,1466,3,720,0
48,1,1756,1466,3,290,0
40,1,1181,1466,5,285,1
94,1,1766,1466,1,300,0
57,1,1662,1466,6,196,0
165,2,1869,1724,2,145,1
139,0,1727,1627,2,100,0
78,1,1750,1715,2,35,0
94,0,1887,1715,5,172,0
38,1,1715,1887,9,172,1
3,0,1677,1716,1,39,0
85,2,1707,1637,5,70,1
48,1,1707,1193,3,514,0
52,1,1707,2000,2,293,1
53,2,2000,1707,5,293,1
115,2,1694,1755,4,61,0
85,2,1683,1708,5,25,0
56,1,1692,1756,5,64,1
42,1,1275,1692,11,417,1
45,2,1707,1703,5,4,1
164,0,1862,1698,1,164,0
43,2,1683,1814,6,131,0
101,2,1677,1460,4,217,1
121,0,1500,1677,1,177,0
80,1,1677,1500,4,177,0
32,1,1500,1677,5,177,1
88,1,1677,1245,6,432,0
106,1,1728,1677,5,51,0
48,2,1677,1500,3,177,1
89,2,1677,1728,6,51,0
54,1,1687,1732,5,45,1
77,2,2060,1687,2,373,1
94,1,1699,1704,2,5,1
147,2,1834,1699,5,135,1
63,2,1699,1834,6,135,0
61,2,1504,1398,4,106,1
62,1,1506,1978,3,472,1
65,2,1494,1348,6,146,1
52,1,1522,1360,4,162,0
11,2,1342,1553,2,211,0
14,1,1924,1512,7,412,0
65,2,1554,1532,5,22,1
102,1,1623,1530,2,93,0
48,1,1511,1614,2,103,1
49,2,1607,1463,2,144,1
49,2,1606,1101,1,505,1
47,2,1596,1535,2,61,1
62,1,1600,1880,5,280,1
66,1,1607,1771,2,164,1
90,1,1619,1593,2,26,0
44,1,1634,1526,2,108,0
89,1,1547,1625,3,78,1
92,1,1799,1634,3,165,0
31,2,1634,1601,6,33,1
30,1,1789,1607,4,182,0
59,2,1901,1613,5,288,1
18,2,1638,1631,1,7,1
155,2,1854,1631,5,223,1
61,2,1627,1661,3,34,0
59,2,2048,1661,8,387,1
13,2,1629,1858,2,229,0
58,1,1895,1831,5,64,0
69,2,1895,1636,5,259,1
87,0,1895,1893,5,2,0
122,1,1675,1895,3,220,1
24,1,1768,1895,3,127,1
117,2,1853,1895,2,42,0
62,1,1895,1774,7,121,0
84,1,1808,1752,3,56,0
44,1,1631,1500,2,131,0
63,2,1804,1703,4,101,1
43,2,1633,1591,5,42,1
26,1,1606,1465,7,141,0
24,1,1472,1599,6,127,1
23,2,1589,1569,8,20,1
58,1,1600,1595,4,5,0
69,2,1571,1612,8,41,0
36,1,1626,1536,11,90,0
66,1,1561,1616,3,55,1
29,2,1610,1427,5,183,1
88,1,1328,1607,3,279,1
42,1,1616,1673,7,57,1
77,2,1448,1632,3,184,0
15,1,1646,1573,5,73,0
47,2,1636,1601,4,35,1
84,1,1525,1628,5,103,1
43,2,1618,1579,3,39,1
33,2,1689,1627,9,62,1
45,2,1689,1637,11,52,1
29,1,1650,1585,6,65,0
49,2,1642,1541,8,101,1
33,2,1633,1550,10,83,1
51,1,1647,1562,8,85,0
41,2,1766,1655,2,111,1
22,2,1822,1662,8,160,1
22,1,1672,1706,4,34,1
58,1,1682,1744,6,62,1
92,1,1757,1667,9,90,0
76,1,1680,1673,5,7,0
47,2,1669,1629,11,40,1
23,2,1708,1680,6,28,1
146,0,1682,1629,8,53,0
90,1,1500,1676,4,176,1
34,2,1664,1649,12,15,1
27,2,1640,1664,5,24,0
52,1,1664,1626,11,38,0
97,2,1618,1640,3,22,0
80,1,1648,1792,4,144,1
20,1,1342,1632,1,290,1
18,1,1402,1642,8,240,1
5,2,1706,1402,1,304,1
40,2,1702,1500,2,202,1
5,2,1348,1545,1,197,0
71,2,1110,1500,1,390,0
13,2,1110,1500,2,390,0
97,2,1110,1500,1,390,0
114,1,1968,2344,7,376,1
86,1,2230,1948,10,282,0
53,2,1933,2008,5,75,0
127,2,2003,1942,9,61,1
92,1,1953,1957,3,4,1
81,2,1939,2011,6,72,0
45,2,2197,1943,5,254,1
79,2,2264,1946,6,318,1
34,1,1949,2260,3,311,1
83,2,1934,2045,2,111,0
92,1,1939,2129,6,190,1
65,2,2104,1939,6,165,1
66,1,1947,2060,11,113,1
72,1,1954,2082,3,128,1
102,1,1965,1940,2,25,0
31,2,1533,1270,3,263,1
45,2,1679,1294,3,385,1
32,1,1352,1577,3,225,1
57,2,1514,2032,2,518,0
4,2,1775,1514,1,261,1
50,1,1514,2032,6,518,1
55,2,1514,1333,7,181,1
45,1,1531,1514,6,17,0
27,2,1514,1836,5,322,0
59,2,1521,1514,4,7,1
11,2,1511,1514,5,3,0
7,2,1554,1104,5,450,1
126,1,1364,1033,4,331,0
69,2,1033,1500,3,467,0
49,2,1442,1041,2,401,1
40,1,1050,1439,2,389,1
51,2,1437,1060,2,377,1
39,2,1842,1060,4,782,1
85,2,1362,1076,3,286,1
64,2,1388,1112,6,276,1
10,1,1137,1383,2,246,1
13,2,1378,1170,4,208,1
78,1,1218,1371,4,153,1
21,2,1363,1299,3,64,1
31,2,1605,1352,5,253,1
65,2,1559,1500,5,59,1
41,2,2005,978,7,1027,1
54,1,978,2005,4,1027,1
108,0,1483,2005,4,522,0
139,2,2005,1895,2,110,1
162,1,1878,2005,4,127,1
76,2,1088,1217,6,129,0
30,1,1224,1372,5,148,1
45,2,1209,1237,2,28,0
115,2,1504,1241,2,263,1
71,2,1225,1378,6,153,0
29,2,1222,1356,6,134,0
115,2,1202,1522,5,320,0
97,1,1132,1193,3,61,1
36,1,1202,1513,6,311,1
55,1,1207,1422,3,215,1
62,2,1328,1215,2,113,1
52,1,1224,1294,6,70,1
62,1,1121,1212,2,91,1
36,1,1221,1334,4,113,1
68,1,1350,1204,2,146,0
50,1,1212,1331,2,119,1
34,1,1216,1523,4,307,1
30,1,1228,1222,6,6,0
29,1,1233,1215,3,18,0
63,2,1340,1235,7,105,1
22,1,1242,1402,3,160,1
30,2,1230,1246,3,16,0
56,1,1594,1225,3,369,0
37,2,1442,1230,7,212,1
99,2,1222,1314,4,92,0
16,1,1329,1206,2,123,0
78,1,1198,1316,6,118,1
81,1,1206,1341,3,135,1
115,2,1196,1112,4,84,1
31,2,1081,1213,3,132,0
32,1,1528,1192,3,336,0
54,1,1199,1359,3,160,1
18,2,1829,1420,5,409,1
26,1,2212,1829,6,383,0
11,2,1829,1544,5,285,1
96,1,1829,1641,8,188,0
42,1,1799,1811,7,12,1
37,2,1830,1830,3,0,0
22,2,1558,1500,2,58,1
53,2,1190,949,2,241,1
62,1,966,1185,3,219,1
78,1,915,910,2,5,0
78,1,932,1389,6,457,1
35,2,1041,932,2,109,1
58,1,1015,1007,2,8,0
40,1,1223,1333,2,110,1
27,2,1324,1321,3,3,1
75,2,1531,1190,2,341,1
24,1,1264,1477,4,213,1
7,2,1350,1500,3,150,0
56,1,1500,1670,3,170,1
12,1,946,1545,2,599,1
9,2,1500,987,2,513,1
63,2,1899,1263,2,636,1
52,1,1272,1807,2,535,1
58,1,1628,1532,3,96,0
74,1,1662,1584,4,78,0
109,2,1802,1662,3,140,1
85,2,1635,1625,8,10,1
23,1,1705,1599,6,106,0
65,2,1683,1627,3,56,1
64,2,1672,1663,3,9,1
37,2,1667,1708,6,41,0
45,2,1661,1677,7,16,0
37,1,1614,1608,4,6,0
77,1,1631,1531,1,100,0
129,2,1545,1616,5,71,0
119,2,1526,1536,3,10,0
79,2,1342,1580,7,238,0
62,2,1667,1394,3,273,1
32,2,1500,1394,2,106,1
114,1,1500,1675,7,175,1
44,1,1923,1974,5,51,1
75,2,1747,1962,4,215,0
57,2,1774,2003,4,229,0
65,2,2024,2031,3,7,0
106,1,1771,2019,1,248,1
76,1,2052,2028,5,24,0
151,2,1605,2114,3,509,0
57,2,2103,1822,4,281,1
75,2,2074,2013,6,61,1
57,1,1982,2042,4,60,1
33,0,2050,1981,16,69,0
152,0,1978,2061,4,83,0
33,2,2074,2121,4,47,0
96,1,2209,2044,3,165,0
114,1,1689,2201,3,512,1
67,2,2198,1519,5,679,1
126,1,1524,2195,3,671,1
27,2,2195,2137,5,58,1
94,1,1357,2193,5,836,1
55,2,2192,1357,4,835,1
116,1,1609,2192,3,583,1
13,2,2192,1609,6,583,1
71,2,2130,2054,7,76,1
57,2,2113,1692,3,421,1
1,2,1484,2113,1,629,0
61,2,2099,1627,6,472,1
22,1,1629,2082,9,453,1
50,2,1757,1896,4,139,0
24,0,2007,1500,5,507,0
33,2,1467,1305,2,162,1
58,1,1333,1289,2,44,0
49,2,1271,1346,4,75,0
39,2,1572,1276,4,296,1
34,1,1281,1568,4,287,1
44,1,1282,1213,4,69,0
30,1,1298,1285,7,13,0
50,1,1301,1664,4,363,1
88,1,1642,1273,3,369,0
76,1,1529,1247,2,282,0
71,2,1515,1253,2,262,1
60,1,1270,1247,6,23,0
49,2,1233,1289,5,56,0
103,2,1542,1295,2,247,1
69,1,1295,1733,2,438,1
45,1,1305,1479,4,174,1
77,2,1282,1394,4,112,0
101,2,1342,1298,3,44,1
58,2,1281,1286,2,5,0
79,2,1655,1286,2,369,1
18,1,1500,1247,3,253,0
73,2,1368,1500,4,132,0
3,2,1500,1500,3,0,0
9,2,1581,1631,5,50,0
53,1,1504,1631,8,127,1
90,1,1631,1606,7,25,0
41,2,1500,1631,5,131,0
61,2,1711,1631,9,80,1
45,2,1594,1631,8,37,0
63,2,1631,1546,3,85,1
69,2,1617,1674,5,57,0
103,2,1950,1620,9,330,1
68,0,1608,1591,3,17,0
47,2,1600,1432,4,168,1
60,0,1626,1599,6,27,0
50,1,1699,1581,5,118,0
51,2,1562,1714,5,152,0
16,2,1302,1585,2,283,0
38,1,1593,1737,8,144,1
23,2,1730,1603,6,127,1
48,1,1611,1775,3,164,1
40,1,1635,1595,4,40,0
70,1,1604,1757,8,153,1
72,1,1589,1588,3,1,0
66,1,1588,1500,5,88,0
76,1,1500,1588,3,88,1
28,2,1588,1203,4,385,1
111,2,1588,1500,4,88,1
49,1,1296,1588,4,292,1
70,1,1697,1566,4,131,0
38,1,1662,1586,4,76,0
43,2,1586,1662,4,76,0
3,2,1362,1265,2,97,1
3,2,1362,1265,2,97,1
50,1,1265,1500,4,235,1
30,1,1500,1265,7,235,0
50,1,1265,1500,1,235,1
10,1,1099,1574,2,475,1
21,2,1459,1143,6,316,1
20,1,1175,1455,1,280,1
43,2,1466,1500,2,34,0
29,2,1773,1366,3,407,1
34,1,1385,1246,2,139,0
40,1,1300,1374,3,74,1
63,2,1320,1391,1,71,0
41,2,1293,1411,4,118,0
19,1,1230,1402,5,172,1
65,2,1611,1410,4,201,1
93,2,1321,1430,5,109,0
78,1,1292,1419,1,127,1
38,1,1205,1412,6,207,1
32,1,1306,1400,8,94,1
56,1,1257,1389,3,132,1
34,1,1188,1381,4,193,1
101,2,1399,1399,4,0,0
74,1,1279,1386,3,107,1
62,1,1485,1362,5,123,0
60,1,1387,1246,7,141,0
19,2,1373,1286,4,87,1
24,1,1348,1353,1,5,1
66,1,1374,1377,2,3,1
53,2,1347,1455,2,108,0
29,2,1324,1311,5,13,1
93,2,1461,1500,4,39,0
20,1,981,1318,11,337,1
35,1,1224,1298,2,74,1
41,2,1426,1317,2,109,1
69,2,1479,1334,8,145,1
61,2,1309,1253,6,56,1
30,1,1333,1423,3,90,1
35,2,1331,1371,4,40,0
41,2,1464,1403,3,61,1
60,2,1564,1430,9,134,1
30,1,886,1426,4,540,1
62,1,1486,1391,5,95,0
67,2,1543,1539,5,4,1
44,1,1490,1472,4,18,0
41,2,1590,1539,4,51,1
50,1,1438,1497,2,59,1
74,1,1457,1164,6,293,0
94,1,1468,1484,8,16,1
66,2,1499,1478,4,21,1
34,1,1407,1468,7,61,1
9,2,1392,1483,5,91,0
40,2,1366,1483,5,117,0
55,2,1366,1483,3,117,0
23,2,1474,1365,3,109,1
88,1,1485,1512,2,27,1
43,2,1184,1485,1,301,0
29,1,1495,1565,6,70,1
29,2,1495,1257,4,238,1
52,1,1366,1495,3,129,1
57,2,1476,1740,7,264,0
57,2,1399,1491,4,92,0
24,1,1464,1479,3,15,1
4,2,1500,1479,1,21,1
66,1,1479,1810,6,331,1
66,1,1479,1810,3,331,1
99,2,1462,1605,5,143,0
35,2,1450,1432,3,18,1
54,1,1437,1632,6,195,1
49,1,1444,1642,3,198,1
37,2,1795,1700,9,95,1
81,2,1776,1829,6,53,0
63,2,1813,1792,5,21,1
52,2,1992,1801,11,191,1
52,1,1858,1779,3,79,0
64,1,1784,2085,12,301,1
46,1,1797,1931,5,134,1
43,2,2074,1804,3,270,1
16,1,1887,1777,1,110,0
69,2,1747,1902,3,155,0
79,2,1424,1500,3,76,0
47,2,1568,1561,4,7,1
40,1,1576,1687,6,111,1
58,1,1582,1773,2,191,1
106,1,1581,1667,6,86,1
74,1,1590,1697,7,107,1
49,2,1578,1569,10,9,1
40,1,1583,1820,6,237,1
44,1,1601,1423,5,178,0
39,2,1599,1484,4,115,1
113,2,1597,1134,8,463,1
67,2,1591,1392,7,199,1
74,1,1613,1257,9,356,0
62,1,1628,1276,7,352,0
31,2,1622,1430,5,192,1
87,2,1616,1459,5,157,1
109,2,1606,1537,5,69,1
136,1,1623,1473,6,150,0
55,2,1612,1582,3,30,1
131,0,1613,1406,6,207,0
65,2,1602,1572,5,30,1
97,2,1593,1509,2,84,1
10,2,1583,1554,5,29,1
55,2,1573,1496,9,77,1
49,1,1585,1591,4,6,1
65,2,1582,1260,8,322,1
29,2,1578,1277,2,301,1
56,1,1580,2002,5,422,1
65,2,1573,1500,11,73,1
124,2,1564,1461,6,103,1
100,2,1557,1500,7,57,1
70,1,1566,1643,6,77,1
55,1,1595,1483,2,112,0
33,2,1591,1338,5,253,1
110,1,1606,1498,8,108,0
55,2,1602,1343,6,259,1
44,2,1600,1175,7,425,1
72,1,1616,1467,4,149,0
67,2,1605,1575,9,30,1
47,2,1598,1451,5,147,1
21,2,1592,1401,6,191,1
19,2,1587,1347,5,240,1
63,2,1577,1500,5,77,1
37,2,1565,1548,6,17,1
30,2,1561,1275,6,286,1
82,1,1461,1253,3,208,0
26,2,1377,1500,3,123,0
49,2,1327,1364,5,37,0
36,1,1070,1802,2,732,1
68,1,1097,1171,3,74,1
7,2,1271,1130,3,141,1
10,1,1130,1455,3,325,1
15,2,1568,1307,4,261,1
10,1,1240,1602,2,362,1
16,1,1240,1422,3,182,1
18,1,1240,1587,3,347,1
26,1,1295,1322,4,27,1
17,1,1380,1189,5,191,0
112,1,1271,1624,3,353,1
84,1,1500,1749,7,249,1
44,1,1500,1404,2,96,0
84,1,1838,1774,6,64,0
19,2,1172,1774,9,602,0
55,1,1241,1744,4,503,1
73,2,1667,1644,3,23,1
39,2,1904,1648,4,256,1
48,1,1661,1619,7,42,0
41,2,1677,1672,4,5,1
79,2,1661,1632,3,29,1
32,1,1683,1651,7,32,0
28,1,1652,2159,8,507,1
52,1,1364,1649,2,285,1
48,1,1653,1889,6,236,1
65,2,1674,1657,2,17,1
84,1,1664,1810,4,146,1
51,1,1673,1722,10,49,1
18,2,1625,1500,3,125,1
3,2,1240,1161,3,79,1
25,1,1323,1441,3,118,1
78,1,1500,1496,4,4,0
20,1,1349,1500,4,151,1
61,2,1066,1174,7,108,0
21,2,1262,1236,7,26,1
47,2,1460,1279,6,181,1
80,1,1390,1346,11,44,0
88,1,1571,1784,4,213,1
59,2,1806,1577,9,229,1
35,1,1584,1737,10,153,1
43,1,1597,1583,2,14,0
37,2,2081,1599,2,482,1
101,2,1592,1390,2,202,1
63,2,1828,1598,4,230,1
122,0,1648,1596,8,52,0
78,1,1613,1520,7,93,0
56,1,1495,1603,9,108,1
73,2,1599,1274,3,325,1
111,0,1875,1589,2,286,0
45,2,1636,1601,2,35,1
72,1,1657,1584,1,73,0
17,2,1576,1373,5,203,1
69,1,1593,1549,3,44,0
82,1,1606,1644,3,38,1
16,1,1678,1586,8,92,0
93,2,1790,1594,5,196,1
54,1,1597,2007,4,410,1
55,2,1581,1566,3,15,1
57,2,1495,1500,4,5,0
77,2,1040,1215,2,175,0
62,1,1215,1500,1,285,1
56,1,1289,1442,3,153,1
39,2,1434,1500,5,66,0
15,2,1500,1266,11,234,1
53,2,1525,1888,5,363,0
85,2,1861,1797,1,64,1
31,2,1824,1805,13,19,1
55,2,1786,1748,5,38,1
81,2,1710,1972,1,262,0
67,2,1650,1695,7,45,0
37,2,1565,1709,5,144,0
46,1,1637,1462,5,175,0
56,1,1578,1325,6,253,0
68,1,1326,1480,1,154,1
52,2,1500,1326,2,174,1
16,1,1363,1740,2,377,1
75,2,1500,1615,6,115,0
48,1,1270,1372,2,102,1
68,1,1328,1372,4,44,1
130,1,1372,1293,2,79,0
94,1,1336,1372,1,36,1
46,1,826,1372,5,546,1
34,1,1500,1372,1,128,0
46,1,1372,1500,2,128,1
67,2,1500,1372,3,128,1
59,2,1500,1372,7,128,1
56,1,1372,1500,3,128,1
106,1,1372,1500,2,128,1
103,2,1500,1372,9,128,1
75,2,1372,2093,2,721,0
75,2,1500,1372,2,128,1
34,1,1372,1500,3,128,1
54,1,1372,1500,2,128,1
93,0,1372,1500,4,128,0
109,2,1500,1372,10,128,1
57,2,1710,1376,3,334,1
55,2,1708,1851,7,143,0
53,1,1245,1336,4,91,1
48,2,1599,2051,5,452,0
52,1,1446,1556,3,110,1
92,0,1418,1589,3,171,0
105,2,1512,1465,5,47,1
55,2,1470,1195,1,275,1
38,2,1559,1641,4,82,0
41,0,1771,1500,8,271,0
75,2,1420,1483,4,63,0
113,2,1421,1315,3,106,1
4,2,1240,1240,3,0,0
36,2,2078,1960,6,118,1
36,1,1969,2023,7,54,1
27,2,1936,1980,6,44,0
27,1,1757,1866,3,109,1
37,1,1675,1500,3,175,0
49,2,1887,1500,4,387,1
16,1,1371,1575,1,204,1
57,2,1314,1398,4,84,0
107,2,1628,1408,5,220,1
121,2,1514,1425,8,89,1
18,1,1446,1505,6,59,1
90,1,1448,1418,6,30,0
49,2,1377,1451,3,74,0
61,2,1424,1396,4,28,1
66,1,1434,1737,4,303,1
41,2,1407,1500,3,93,0
42,1,1446,1364,6,82,0
21,1,1398,1436,5,38,1
33,2,1418,1443,6,25,0
51,2,1443,1499,4,56,0
56,1,1288,1470,4,182,1
37,2,1431,1295,5,136,1
35,2,1358,1367,2,9,0
86,1,1289,1260,5,29,0
33,2,1245,1260,1,15,0
41,2,1260,1245,4,15,1
30,1,1260,1565,11,305,1
20,1,1714,1260,10,454,0
114,1,1222,1260,2,38,1
36,1,1260,1222,5,38,0
20,1,1260,1222,3,38,0
47,2,1260,1392,2,132,0
66,1,1392,1260,1,132,0
49,2,1500,1260,7,240,1
34,1,1279,1716,4,437,1
63,2,1279,1488,3,209,0
95,2,1461,1279,4,182,1
40,1,1336,1563,5,227,1
54,1,1347,1938,3,591,1
32,1,1500,1549,3,49,1
54,1,1500,1591,4,91,1
74,1,1591,1500,2,91,0
79,2,1591,1500,2,91,1
107,2,1591,1500,2,91,1
35,2,1331,1500,6,169,0
64,1,1492,1500,3,8,1
40,1,1512,1500,3,12,0
2,1,1500,1500,2,0,0
36,1,1400,1500,6,100,1
46,1,1500,1696,1,196,1
60,1,1250,1208,1,42,0
12,1,1213,1599,6,386,1
15,2,1626,1217,5,409,1
17,2,1700,1220,8,480,1
87,2,1937,1221,5,716,1
29,2,1596,1229,7,367,1
25,2,1508,1237,4,271,1
27,2,1393,1251,5,142,1
41,2,1512,1261,3,251,1
33,1,1266,1669,3,403,1
59,2,1426,1282,3,144,1
23,2,1625,1289,3,336,1
17,2,1502,1302,6,200,1
46,1,1330,1340,7,10,1
26,1,1350,1765,4,415,1
76,1,1640,1290,3,350,0
87,2,1443,1313,3,130,1
89,2,1847,1287,4,560,1
43,2,1636,1298,4,338,1
61,1,1500,1298,3,202,0
33,2,1323,1318,3,5,1
29,2,1457,1327,3,130,1
50,1,1289,1275,1,14,0
39,2,1189,1410,2,221,0
96,1,1189,1366,3,177,1
86,1,1367,1208,1,159,0
30,1,1367,1208,1,159,0
25,2,1505,1229,2,276,1
15,2,1161,1244,2,83,0
20,1,1161,1465,3,304,1
21,2,2022,1162,3,860,1
17,2,1465,1189,1,276,1
45,2,1292,1422,2,130,0
71,2,2054,1977,8,77,1
81,2,1696,2054,7,358,0
68,1,2054,1626,6,428,0
2,1,2073,2257,2,184,1
4,1,2104,2081,3,23,0
2,1,2159,1500,2,659,0
2,1,1816,2230,2,414,1
37,2,2098,2279,3,181,0
39,0,2002,2302,3,300,0
23,2,2276,2111,5,165,1
33,2,1500,2352,1,852,0
2,1,1425,2346,2,921,1
2,1,1836,2340,2,504,1
2,1,1921,2322,2,401,1
2,1,1491,2318,2,827,1
90,1,1305,2318,7,1013,1
2,1,1654,2314,2,660,1
2,1,1500,2314,2,814,1
2,1,1513,2312,2,799,1
27,2,1591,1348,3,243,1
19,2,1531,1354,3,177,1
23,2,1337,1567,5,230,0
53,1,1349,1308,3,41,0
28,1,1354,1337,8,17,0
14,1,1345,1471,4,126,1
26,1,1352,1503,3,151,1
45,2,1336,1364,6,28,0
39,2,1527,1371,6,156,1
35,2,1572,1376,5,196,1
34,1,1382,1567,3,185,1
34,2,1372,1395,8,23,0
61,2,1412,1406,11,6,1
26,1,1414,1557,7,143,1
41,2,1398,1515,5,117,0
18,1,1415,1437,2,22,1
46,1,1421,1630,9,209,1
75,2,1624,1427,3,197,1
48,1,1439,1422,4,17,0
14,1,1454,1427,5,27,0
33,2,1413,1441,2,28,0
42,1,1444,1400,5,44,0
37,2,1518,1408,6,110,1
101,2,1394,1442,5,48,0
51,2,1380,1418,2,38,0
22,1,1500,1369,8,131,0
45,2,1770,1372,4,398,1
42,1,1374,1848,5,474,1
35,2,1457,1384,6,73,1
42,1,1480,1368,5,112,0
31,0,1313,1370,6,57,0
47,2,1359,1323,4,36,1
28,1,1361,1755,10,394,1
39,2,1752,1363,8,389,1
54,1,1373,1464,3,91,1
86,1,1373,2007,7,634,1
62,0,1197,1379,6,182,0
20,1,1382,1748,8,366,1
136,1,1778,1360,7,418,0
55,2,1547,1366,8,181,1
38,2,1279,1408,7,129,0
34,1,1599,1473,6,126,0
33,2,1497,1500,2,3,0
105,2,1631,1563,7,68,1
56,1,1500,1563,3,63,1
29,2,1563,1500,4,63,1
42,1,1500,1563,3,63,1
49,2,1952,1563,5,389,1
23,2,1352,1298,6,54,1
26,1,1421,1563,3,142,1
71,2,1485,1352,7,133,1
113,2,1563,1445,7,118,1
62,1,1223,1563,3,340,1
84,2,1702,1375,5,327,1
102,0,1430,1667,2,237,0
63,2,1394,1228,4,166,1
86,1,1511,1500,3,11,0
120,1,2016,2000,2,16,0
101,2,2006,1960,2,46,1
59,2,2043,2017,10,26,1
120,1,1600,2015,2,415,1
64,1,1806,2009,5,203,1
79,2,2000,1920,2,80,1
49,2,1999,1487,2,512,1
33,2,1988,2010,2,22,0
32,1,1927,1978,4,51,1
40,1,1958,1967,1,9,1
65,2,1955,1969,2,14,0
29,1,1970,1853,3,117,0
152,0,1850,1974,2,124,0
130,1,1989,1891,2,98,0
46,1,1948,1978,3,30,1
84,1,1873,1970,6,97,1
144,1,1987,1797,2,190,0
58,1,1670,1984,4,314,1
68,1,1880,1975,9,95,1
61,2,1968,1809,2,159,1
49,2,1956,1992,13,36,0
48,2,1951,1718,4,233,1
73,2,1942,1845,4,97,1
104,1,1853,1933,8,80,1
19,2,1923,1862,3,61,1
33,2,1915,1794,3,121,1
74,1,1160,1915,3,755,1
85,2,2098,1920,5,178,1
114,1,1846,1910,2,64,1
13,2,1904,1752,4,152,1
59,2,1890,1959,2,69,0
33,2,1895,1760,4,135,1
30,1,1719,1907,5,188,1
30,2,1900,1725,3,175,1
69,2,1890,1846,4,44,1
110,1,1856,1878,5,22,1
86,1,1746,1870,5,124,1
40,1,1121,1355,2,234,1
29,2,1208,1500,4,292,0
64,1,1383,1226,2,157,0
57,2,1339,1500,3,161,0
26,1,1290,975,4,315,0
11,0,950,1297,1,347,0
21,2,1794,951,3,843,1
52,1,951,1793,1,842,1
16,2,1496,954,2,542,1
23,2,1488,957,3,531,1
3,2,1146,996,3,150,1
50,1,992,1318,1,326,1
63,2,1434,1041,6,393,1
26,2,1659,1044,4,615,1
53,2,1518,1050,5,468,1
61,1,1068,1304,1,236,1
19,2,1298,1092,5,206,1
68,1,1133,1218,1,85,1
15,2,1216,1191,1,25,1
29,2,1777,1197,9,580,1
2,1,1500,1246,2,254,0
12,1,895,1164,4,269,1
36,1,871,1006,3,135,1
19,1,957,1058,2,101,1
57,2,1334,880,3,454,1
3,1,1392,1914,3,522,1
50,1,1500,1392,2,108,0
123,2,1392,1500,2,108,0
68,1,1500,1669,4,169,1
51,2,1761,1515,3,246,1
33,2,1499,1268,3,231,1
87,2,1491,1367,4,124,1
42,1,1502,1736,5,234,1
83,2,1495,1342,4,153,1
45,2,1504,1585,9,81,0
47,2,1502,1128,5,374,1
34,1,1497,1521,2,24,1
108,1,1504,1606,5,102,1
70,1,1508,1796,5,288,1
49,2,1496,1507,5,11,0
68,1,1507,1532,3,25,1
35,2,1488,1698,9,210,0
61,2,1479,1398,3,81,1
64,2,1475,1165,3,310,1
28,2,1469,1273,3,196,1
57,2,1448,1748,10,300,0
90,1,1454,1663,10,209,1
17,2,1440,1480,3,40,0
84,1,1452,1463,12,11,1
41,2,1420,1420,4,0,0
68,1,1432,1454,3,22,1
53,2,1414,1550,10,136,0
94,1,1428,1394,5,34,0
15,2,1421,1236,3,185,1
54,1,1426,1929,4,503,1
60,2,1409,1570,4,161,0
41,2,1406,1035,5,371,1
41,2,1401,1111,9,290,1
60,1,1398,1293,6,105,0
23,1,1399,1630,5,231,1
169,2,1379,1563,10,184,0
44,1,1382,1778,5,396,1
30,1,1387,1623,9,236,1
43,2,1379,1228,3,151,1
40,1,1387,1547,1,160,1
46,1,1411,1584,2,173,1
31,2,1393,1483,9,90,0
118,1,1404,1499,5,95,1
29,2,1555,1500,2,55,1
35,2,1564,1503,4,61,1
93,2,1465,1416,4,49,1
92,1,1426,1436,2,10,1
112,1,1473,1414,2,59,0
74,1,1424,1440,2,16,1
28,1,1486,1412,4,74,0
39,2,1398,1544,1,146,0
73,2,1511,1405,2,106,1
88,1,1679,1342,4,337,0
36,1,1462,1500,2,38,1
99,2,1602,1424,3,178,1
138,1,1500,1791,6,291,1
70,1,1700,1675,4,25,0
56,1,1711,1652,3,59,0
64,1,1722,1723,3,1,1
131,1,1734,1710,4,24,0
81,2,1704,1551,2,153,1
54,1,1713,1768,2,55,1
94,2,1701,1758,4,57,0
46,1,1713,1668,2,45,0
57,2,1703,1678,2,25,1
56,2,1695,1600,2,95,1
54,1,1709,1610,2,99,0
45,2,1700,1620,2,80,1
62,1,1629,1691,5,62,1
140,1,1705,1616,2,89,0
67,2,1781,1715,6,66,1
27,1,1724,1771,2,47,1
87,2,1720,1481,2,239,1
88,1,1734,1634,4,100,0
39,2,1719,1856,2,137,0
77,2,1458,1738,3,280,0
78,2,1728,1689,2,39,1
32,2,1717,1699,3,18,1
40,1,1710,1705,5,5,0
134,0,1705,1710,4,5,0
89,2,1446,1725,4,279,0
78,2,1721,1450,1,271,1
83,2,1709,1695,2,14,1
60,2,1697,1718,3,21,0
80,2,1689,1578,2,111,1
127,0,1691,1626,3,65,0
43,2,1681,1733,1,52,0
46,1,1685,1946,2,261,1
89,2,1682,1350,2,332,1
90,1,1697,1546,2,151,0
64,1,1714,1553,2,161,0
81,2,1699,1809,2,110,0
55,2,1693,1521,2,172,1
99,2,1680,1713,3,33,0
79,2,1674,1491,2,183,1
161,0,1846,1669,3,177,0
48,1,1675,1858,2,183,1
12,1,1551,1667,6,116,1
60,2,1662,1408,2,254,1
40,2,1651,1629,3,22,1
107,0,1663,1300,3,363,0
101,2,1655,1518,3,137,1
51,2,1381,1583,3,202,0
144,1,1749,1716,8,33,0
22,1,1551,1697,4,146,1
49,2,1685,1390,4,295,1
37,2,1735,1500,3,235,1
116,1,1766,1826,6,60,1
30,1,1425,1754,2,329,1
57,1,1799,1500,2,299,0
65,2,1760,1711,4,49,1
20,1,1723,1706,8,17,0
57,2,1710,1777,3,67,0
67,2,1750,1500,2,250,1
31,2,1383,1500,4,117,0
52,1,1277,1342,2,65,1
47,2,1342,1299,3,43,1
47,1,1357,904,3,453,0
11,2,1341,1259,2,82,1
102,1,1280,1341,3,61,1
49,2,1336,1099,3,237,1
27,2,1336,1190,2,146,1
38,1,1336,1259,4,77,0
10,1,944,1336,1,392,1
59,2,1336,944,3,392,1
54,2,1336,1217,4,119,1
51,2,1336,1273,4,63,1
47,2,1202,1336,4,134,0
50,2,1500,1354,4,146,1
10,1,1354,1680,2,326,1
97,2,1404,1354,4,50,1
70,1,1354,1181,5,173,0
41,2,1354,1289,3,65,1
38,1,1140,1637,2,497,1
32,1,1140,1498,2,358,1
24,1,1464,1106,2,358,0
12,1,1084,1099,1,15,1
32,2,1362,1094,4,268,1
6,1,1101,1478,1,377,1
25,2,1070,1265,1,195,0
29,2,1257,1091,4,166,1
15,1,1116,1247,2,131,1
3,2,1236,1150,1,86,1
29,2,1535,1160,3,375,1
12,1,1185,1390,1,205,1
9,2,1099,1290,1,191,0
6,1,1139,1283,1,144,1
14,1,1171,1554,1,383,1
16,1,1199,1503,1,304,1
13,2,1498,1238,3,260,1
12,1,1304,1493,2,189,1
13,2,1460,1500,4,40,0
2,1,988,1056,1,68,1
13,2,1041,1500,2,459,0
3,1,1148,1614,3,466,1
25,1,1149,1796,5,647,1
28,2,1669,1149,5,520,1
55,2,1149,1669,4,520,0
11,2,1669,1149,4,520,1
43,1,1149,1669,1,520,1
2,1,1149,1669,2,520,1
46,1,1149,1672,6,523,1
18,2,1672,1149,4,523,1
28,1,1149,1672,1,523,1
5,2,1672,1149,3,523,1
2,1,1149,1672,2,523,1
14,2,1672,1149,7,523,1
17,1,1149,1672,6,523,1
45,2,1672,1149,4,523,1
62,1,1149,1672,4,523,1
25,1,1151,1578,9,427,1
47,2,1125,1643,7,518,0
102,1,1830,1500,4,330,0
102,0,1430,1667,2,237,0
22,1,1331,1661,3,330,1
92,1,1337,1623,3,286,1
44,1,1500,1545,3,45,1
102,1,1500,1430,2,70,0
69,2,2235,1500,9,735,1
54,1,2022,2226,2,204,1
32,2,2216,2029,8,187,1
31,2,2210,1912,4,298,1
47,2,2202,1965,3,237,1
14,1,1183,1431,4,248,1
51,2,1503,1500,1,3,1
44,1,1892,2344,4,452,1
61,2,1028,1500,4,472,0
56,1,1603,2241,7,638,1
53,2,2238,1742,6,496,1
96,1,1613,2237,2,624,1
63,2,2235,1652,1,583,1
134,1,2263,2136,5,127,0
46,1,1800,2260,9,460,1
80,1,1737,2257,1,520,1
72,1,2069,2244,8,175,1
65,2,2229,2077,17,152,1
28,1,1500,1700,1,200,1
53,2,1694,1495,4,199,1
23,1,1408,1690,4,282,1
69,2,1695,1702,1,7,0
53,2,1709,1442,5,267,1
31,2,1675,1722,7,47,0
53,1,1696,1711,7,15,1
49,2,1707,1404,4,303,1
71,2,1697,1660,8,37,1
77,2,1552,1713,7,161,0
29,2,1703,1679,3,24,1
26,1,1657,1693,6,36,1
53,2,1685,1579,3,106,1
26,1,1695,1716,4,21,1
112,1,1527,1677,4,150,1
101,2,1670,1522,3,148,1
101,0,1665,1684,3,19,0
44,2,1650,1574,3,76,1
56,2,1666,1661,7,5,1
31,2,1773,1670,3,103,1
34,1,1687,1657,6,30,0
116,1,1688,1484,7,204,0
47,1,1631,1677,8,46,1
35,2,1670,1542,3,128,1
73,2,1502,1687,4,185,0
28,1,1706,1482,2,224,0
54,0,1837,1426,4,411,0
2,1,856,1423,2,567,1
3,2,1420,859,3,561,1
2,2,1417,861,1,556,1
2,1,864,1414,1,550,1
2,1,867,1410,1,543,1
3,2,1407,871,1,536,1
2,2,1403,874,1,529,1
2,1,877,1399,1,522,1
3,2,1395,881,1,514,1
3,2,1390,885,1,505,1
3,2,1386,889,1,497,1
3,2,1381,893,1,488,1
2,1,897,1375,2,478,1
3,2,1369,902,1,467,1
2,1,908,1363,1,455,1
2,2,1356,913,1,443,1
2,2,1348,919,1,429,1
2,1,926,1340,1,414,1
3,2,1330,934,2,396,1
2,1,943,1319,1,376,1
2,2,1306,953,2,353,1
2,2,1291,965,2,326,1
2,2,1271,979,2,292,1
27,2,1500,1271,11,229,1
18,1,1271,1500,4,229,1
34,1,1169,1369,2,200,1
9,2,1393,1195,6,198,1
43,2,1387,1228,2,159,1
43,0,1195,1386,2,191,0
63,2,1195,1369,5,174,0
95,2,1195,1369,3,174,0
76,1,1195,1247,6,52,1
40,1,1369,1062,4,307,0
44,1,1185,1288,4,103,1
55,0,1291,1117,4,174,0
44,1,1152,1117,3,35,0
108,1,1121,1458,2,337,1
56,1,1580,1402,3,178,0
7,2,1023,879,3,144,1
51,2,1354,1389,2,35,0
56,1,1404,1407,3,3,1
103,2,1668,1427,4,241,1
59,2,1337,1484,2,147,0
30,1,1411,1262,3,149,0
69,2,1218,1452,3,234,0
61,2,1946,1221,5,725,1
37,2,1073,1371,5,298,0
27,2,1208,1445,3,237,0
61,2,1439,1282,4,157,1
41,1,1500,1422,5,78,0
119,2,1146,1200,3,54,0
31,2,1992,1816,12,176,1
60,1,1628,1810,4,182,1
89,2,2102,1810,10,292,1
66,1,1810,2102,5,292,1
64,1,1537,1805,2,268,1
77,2,2101,1805,13,296,1
49,2,2101,1805,10,296,1
71,2,2101,1805,8,296,1
49,2,1784,2121,9,337,0
78,1,1799,1771,3,28,0
35,2,1845,1781,11,64,1
102,1,1800,1565,4,235,0
38,2,1500,1133,2,367,1
3,2,1252,1168,2,84,1
65,2,1392,1168,2,224,1
30,1,1213,1392,1,179,1
85,2,1559,1230,1,329,1
12,1,1250,1556,1,306,1
19,2,1552,1275,2,277,1
37,2,1598,1301,3,297,1
83,2,1500,1301,1,199,1
11,2,1403,1393,1,10,1
31,0,1399,1381,2,18,0
11,2,1693,1500,3,193,1
37,2,1255,1142,2,113,1
29,2,1475,1147,2,328,1
57,2,1394,1152,3,242,1
31,1,1172,1075,2,97,0
44,1,1196,1172,2,24,0
94,1,1336,1058,5,278,0
22,1,1203,1215,6,12,1
42,1,1227,1190,4,37,0
55,2,1171,1381,5,210,0
100,1,1378,1159,2,219,0
9,2,1144,1226,3,82,0
34,1,1244,1141,2,103,0
43,2,1383,1146,4,237,1
48,1,1155,1256,6,101,1
2,1,1305,1734,2,429,1
2,2,1730,1327,1,403,1
2,1,1358,1726,1,368,1
2,2,1720,1405,1,315,1
2,1,1500,1713,2,213,1
10,2,1155,1203,2,48,0
4,2,1448,1181,1,267,1
7,2,1573,1403,2,170,1
3,2,1845,1441,2,404,1
15,2,1585,1441,2,144,1
3,2,1842,1500,2,342,1
28,1,1500,1212,2,288,0
5,2,1853,1500,2,353,1
122,1,2005,1900,10,105,0
66,1,1545,1706,5,161,1
91,2,1567,1796,10,229,0
37,1,1954,1787,5,167,0
55,2,1796,1669,4,127,1
53,2,1774,1690,2,84,1
75,2,1743,1738,6,5,1
67,2,1735,1759,2,24,0
65,2,1765,1654,5,111,1
2,1,1839,1765,2,74,0
39,2,1687,1763,3,76,0
87,2,1580,1716,1,136,0
66,1,1743,2134,3,391,1
74,1,1617,1500,5,117,0
109,2,1500,1793,12,293,0
53,2,1793,1750,4,43,1
42,1,1750,1793,13,43,1
31,2,1793,850,4,943,1
45,2,1793,1254,4,539,1
149,2,2131,1924,9,207,1
120,1,1937,1869,5,68,0
20,2,1276,1111,2,165,1
54,1,1144,1096,2,48,0
44,1,1091,1096,5,5,1
71,2,1072,1111,1,39,0
31,2,1271,1119,2,152,1
52,1,1129,1208,4,79,1
55,2,1633,1131,1,502,1
11,1,1131,1377,6,246,1
46,1,1141,1230,3,89,1
30,1,1151,1248,3,97,1
40,2,1339,1158,2,181,1
11,2,1257,1169,5,88,1
69,2,1216,1182,2,34,1
28,1,1199,1129,5,70,0
18,2,1028,1220,2,192,0
33,2,1201,1236,2,35,0
17,2,1218,1294,2,76,0
74,2,1202,1201,4,1,1
87,2,1507,1207,2,300,1
61,2,1517,1212,3,305,1
82,1,1438,1186,4,252,0
36,1,1698,1155,9,543,0
39,2,1347,1460,1,113,0
14,1,1500,1549,2,49,1
46,2,1500,1389,2,111,1
36,1,1474,1331,2,143,0
83,2,1313,1491,2,178,0
23,1,1317,1430,2,113,1
86,1,1232,1307,2,75,1
35,2,1296,1241,2,55,1
139,2,1370,1226,1,144,1
3,2,1325,1249,2,76,1
45,2,1375,1314,4,61,1
39,2,1502,1321,2,181,1
39,2,1320,1343,3,23,0
29,2,1418,1330,4,88,1
47,2,1311,1433,2,122,0
33,2,1505,1319,2,186,1
62,1,1299,1304,2,5,1
25,1,1309,1601,2,292,1
52,1,1207,1298,2,91,1
60,2,1211,1258,3,47,0
31,2,1242,1248,2,6,0
3,2,1202,1261,2,59,0
23,2,1299,1169,2,130,1
45,2,1153,1322,4,169,0
47,2,1662,1327,4,335,1
39,1,1242,1313,2,71,1
16,1,1334,1294,2,40,0
78,1,986,1289,2,303,1
65,2,1373,1303,4,70,1
57,2,1279,1387,3,108,0
52,1,1376,1263,2,113,0
65,2,1500,1411,4,89,1
50,1,1500,1732,1,232,1
118,1,1500,1500,3,0,0
74,1,1500,1500,4,0,0
67,2,2182,2210,3,28,0
149,2,2622,2188,3,434,1
83,2,2199,2233,2,34,0
97,0,2239,2198,3,41,0
45,2,2184,2200,7,16,0
106,2,2183,2257,5,74,0
53,2,1625,1363,4,262,1
59,2,1587,1500,2,87,1
68,1,1883,2093,4,210,1
75,2,2064,1947,4,117,1
72,1,1713,2054,2,341,1
67,2,2044,1716,4,328,1
49,2,2004,2004,3,0,0
41,2,2004,1744,7,260,1
48,1,1700,1990,5,290,1
50,1,1677,1944,6,267,1
46,1,1613,1927,3,314,1
85,2,1909,1598,2,311,1
23,2,1886,1590,10,296,1
41,2,1831,1733,6,98,1
47,2,1769,1655,6,114,1
71,2,1650,1651,5,1,0
51,2,1500,1447,1,53,1
19,2,1316,1293,5,23,1
5,2,1392,1293,5,99,1
14,2,1334,1293,5,41,1
24,1,1064,1069,3,5,1
52,2,1705,1324,3,381,1
17,2,1498,1500,4,2,0
72,1,1814,2038,6,224,1
80,1,1809,2058,8,249,1
40,1,1838,2048,6,210,1
32,1,2048,1885,3,163,0
58,1,1436,2047,2,611,1
93,2,1441,1392,4,49,1
78,0,2305,1500,7,805,0
19,2,2305,1500,12,805,1
122,1,1500,2305,3,805,1
50,1,2475,2305,11,170,0
129,2,1679,1795,2,116,0
65,2,1500,1689,5,189,0
38,1,1263,1521,3,258,1
32,1,1299,1585,2,286,1
79,2,1504,1387,5,117,1
53,2,1651,1364,3,287,1
38,1,1364,1175,2,189,0
40,1,1364,1501,3,137,1
28,1,1364,1078,3,286,0
15,1,1336,1500,3,164,1
88,2,1510,1303,2,207,1
48,1,1309,1671,5,362,1
39,2,1668,1313,4,355,1
54,1,1316,1665,2,349,1
44,1,1271,1463,3,192,1
21,2,1382,1500,4,118,0
30,1,1234,1288,2,54,1
43,2,1315,1301,2,14,1
50,1,1128,1293,2,165,1
61,2,1338,1306,1,32,1
77,2,1323,1395,2,72,0
35,2,1302,982,1,320,1
23,2,1464,1310,4,154,1
51,1,1371,1306,2,65,0
22,2,1730,1849,4,119,0
93,1,1858,1939,8,81,1
63,2,1850,1870,2,20,0
117,2,1867,1524,2,343,1
35,2,1410,1561,2,151,0
47,2,1670,1575,2,95,1
30,2,1325,1457,6,132,0
46,1,1484,1405,6,79,0
40,1,1291,1471,6,180,1
156,1,1265,1461,2,196,1
47,2,1455,1298,4,157,1
26,1,1316,1635,2,319,1
51,2,1892,1322,6,570,1
44,1,1443,1227,7,216,0
78,2,1795,1234,8,561,1
25,2,1484,1273,2,211,1
36,1,1295,1675,7,380,1
12,2,1672,1322,7,350,1
100,1,1357,1689,4,332,1
19,2,1685,1413,7,272,1
37,1,1500,1741,3,241,1
12,1,1386,1500,3,114,1
126,1,2152,2075,9,77,0
49,2,2064,1889,4,175,1
134,2,1834,2064,8,230,0
41,2,2056,1841,10,215,1
80,1,1848,2049,11,201,1
40,1,1663,2069,3,406,1
73,2,2066,1665,12,401,1
24,1,1616,2064,4,448,1
96,1,1715,2060,3,345,1
91,2,2056,1684,6,372,1
102,1,1687,2052,3,365,1
145,2,1800,2079,3,279,0
102,2,2003,2162,2,159,0
88,1,1723,2159,5,436,1
23,2,2158,1477,11,681,1
77,2,2158,992,3,1166,1
85,2,2156,1640,9,516,1
45,1,1554,2155,4,601,1
35,2,2155,1361,2,794,1
67,2,2153,1555,4,598,1
71,2,2152,1580,2,572,1
66,1,1810,1738,4,72,0
85,2,1724,1824,7,100,0
107,0,1406,1459,7,53,0
41,2,1412,1417,3,5,0
51,2,2315,2200,14,115,1
65,2,2196,1869,15,327,1
51,2,1855,1202,7,653,1
41,1,1202,1009,1,193,0
74,2,1386,1255,4,131,1
33,2,1830,1263,4,567,1
85,2,1781,1274,3,507,1
9,2,1100,1500,5,400,0
15,2,1613,1309,2,304,1
32,1,1364,1609,3,245,1
8,2,1261,1174,4,87,1
57,2,1589,1500,5,89,1
121,2,1238,885,1,353,1
57,2,1708,1500,5,208,1
85,2,1706,886,8,820,1
27,1,788,1307,2,519,1
53,2,1437,892,2,545,1
21,2,955,959,3,4,0
43,2,1411,1500,4,89,0
27,2,1149,1013,2,136,1
51,2,1523,1009,1,514,1
26,1,1028,1521,1,493,1
61,2,1366,1090,4,276,1
41,2,1500,1005,2,495,1
55,2,1130,1500,3,370,0
66,1,1394,1998,5,604,1
47,2,1998,1358,5,640,1
40,1,1276,1997,4,721,1
35,1,2026,1593,12,433,0
65,2,2015,1877,11,138,1
42,1,1527,2013,3,486,1
79,2,2011,1511,4,500,1
74,1,1512,2009,2,497,1
66,1,2037,1734,8,303,0
125,2,1432,2069,9,637,0
50,1,2069,1500,6,569,0
35,1,1144,1500,4,356,1
23,1,1144,1500,6,356,1
52,1,1022,1165,4,143,1
93,2,1781,1516,11,265,1
96,1,1601,1688,5,87,1
103,2,1939,1662,8,277,1
59,2,1500,1500,6,0,0
74,1,1785,1815,8,30,1
53,2,1777,1453,2,324,1
165,0,1571,1457,13,114,0
41,2,1571,1487,8,84,1
65,2,1620,1658,4,38,0
55,2,1648,1630,3,18,1
79,2,1619,1635,2,16,0
54,1,1647,1606,13,41,0
41,1,1617,1637,6,20,1
34,2,1626,1628,6,2,0
26,1,1869,1500,5,369,0
19,2,1500,1500,6,0,0
33,0,1672,1455,6,217,0
11,2,1561,1718,4,157,0
49,2,1703,1475,3,228,1
18,1,1328,1657,4,329,1
25,2,1636,1417,4,219,1
25,2,1500,1681,2,181,0
6,1,801,1223,3,422,1
34,2,1207,804,2,403,1
29,2,1403,1389,2,14,1
44,1,1500,1662,1,162,1
48,1,1484,1500,6,16,1
60,1,1500,1484,3,16,0
67,2,2206,2238,6,32,0
30,1,2252,2121,5,131,0
52,1,2259,2386,5,127,1
40,1,2074,2253,7,179,1
41,2,2247,2094,6,153,1
77,2,2240,2104,6,136,1
84,1,2111,2233,2,122,1
43,2,2226,2119,8,107,1
124,1,2127,2218,2,91,1
62,1,2232,2113,3,119,0
21,2,2225,2096,10,129,1
136,2,2217,2135,3,82,1
82,1,1123,1500,4,377,1
8,1,1506,1282,2,224,0
3,0,1408,1570,3,162,0
83,2,1130,1144,2,14,0
53,2,1158,1500,2,342,0
79,2,1658,1444,8,214,1
118,1,1669,1850,4,181,1
22,1,1565,1652,6,87,1
51,1,1422,1641,1,219,1
33,2,1620,1565,5,55,1
64,1,1846,1576,4,270,0
58,1,1374,1549,6,175,1
47,2,1527,1422,4,105,1
82,1,1448,1500,3,52,1
58,1,1154,1490,4,336,1
50,1,1160,1480,12,320,1
39,2,1433,1515,4,82,0
23,2,1387,1094,6,293,1
52,1,1496,1305,3,191,0
39,2,1195,1491,4,296,0
64,1,1510,1447,4,63,0
37,2,1433,1436,5,3,0
30,0,1436,1433,7,3,0
15,0,1502,1430,3,72,0
10,1,952,1410,4,458,1
31,2,1408,955,7,453,1
170,1,1569,1366,7,203,0
52,1,1366,1269,3,97,0
112,1,1340,1367,3,27,1
60,1,1199,1341,10,142,1
17,2,1176,1398,2,222,0
3,1,1412,1485,3,73,1
78,1,1281,1380,2,99,1
30,1,1359,1359,2,0,0
66,1,1383,1347,6,36,0
56,0,1134,1397,7,263,0
107,2,1412,1211,5,201,1
104,1,1211,1434,1,223,1
14,1,1434,1352,5,82,0
59,2,1410,1337,3,73,1
66,1,1443,1425,4,18,0
32,2,1393,1487,6,94,0
61,2,1225,1552,4,327,0
44,1,1061,1602,7,541,1
8,2,1678,1678,1,0,0
37,2,1615,1727,5,112,0
47,1,1728,1571,3,157,0
53,2,1568,1292,5,276,1
29,2,1273,1653,3,380,0
55,2,1580,1757,7,177,0
72,2,1711,1622,5,89,1
44,1,1631,1540,5,91,0
57,2,1480,1393,7,87,1
68,1,1403,1371,1,32,0
47,0,1552,1283,9,269,0
63,1,1500,1423,5,77,0
47,2,1500,1341,4,159,1
23,2,1419,1362,4,57,1
64,1,1500,1584,3,84,1
37,2,1500,1535,4,35,0
103,2,1506,1588,4,82,0
87,2,1501,1221,4,280,1
47,2,1677,1508,9,169,1
55,2,1627,1515,6,112,1
63,2,1515,1448,2,67,1
43,2,1494,1843,2,349,0
57,2,1690,1501,4,189,1
31,2,1784,1505,7,279,1
52,1,1363,1706,2,343,1
47,2,1703,1366,4,337,1
18,2,1352,1380,3,28,0
51,1,1395,1338,4,57,0
80,1,1349,1383,3,34,1
29,1,1399,1335,6,64,0
27,1,1183,1427,7,244,1
66,1,1405,1632,5,227,1
72,1,1377,1392,6,15,1
8,1,1391,1378,6,13,0
83,2,1453,1389,2,64,1
73,0,1455,1387,2,68,0
103,2,1466,1529,4,63,0
26,2,1466,1297,4,169,1
62,1,1445,1466,4,21,1
150,1,1500,1466,3,34,0
4,1,1415,1466,4,51,1
28,1,1500,1466,1,34,0
88,1,1466,1533,5,67,1
97,1,1549,1466,20,83,0
58,1,1466,1500,5,34,1
39,2,1466,1500,1,34,0
36,1,1500,1466,2,34,0
46,1,1500,1500,2,0,0
101,2,1251,1166,5,85,1
62,1,1216,1584,4,368,1
29,2,1580,1257,3,323,1
111,2,1068,807,3,261,1
97,2,1068,807,3,261,1
48,1,1076,1373,5,297,1
91,2,1076,807,5,269,1
92,1,807,1076,3,269,1
25,2,1076,807,3,269,1
45,2,1011,1076,3,65,0
101,2,1076,1011,3,65,1
32,1,1500,1383,3,117,0
17,2,1529,1088,2,441,1
17,2,1671,1094,1,577,1
23,2,1444,1118,1,326,1
9,1,1121,1831,1,710,1
13,2,1375,1167,2,208,1
21,2,1501,1030,3,471,1
20,2,1312,1274,1,38,1
23,2,1410,1500,3,90,0
47,2,1198,1571,1,373,0
3,2,1500,1202,1,298,1
31,2,1500,1209,8,291,1
15,1,1209,1429,5,220,1
115,2,1527,1212,7,315,1
71,2,1188,1597,7,409,0
37,2,1174,1500,7,326,0
53,1,1500,1174,6,326,0
31,2,1174,1500,5,326,0
14,1,1500,1174,5,326,0
95,2,1174,1500,1,326,0
107,2,1500,1174,4,326,1
70,1,1458,1485,6,27,1
76,1,1613,1472,6,141,0
36,2,2059,1640,4,419,1
69,2,1500,1422,3,78,1
47,2,1667,1500,5,167,1
36,2,1348,1557,5,209,0
73,2,1550,1500,7,50,1
104,1,1588,1533,4,55,0
21,2,1581,1500,4,81,1
12,2,1571,1558,4,13,1
35,2,1560,1522,6,38,1
64,1,1571,1597,7,26,1
47,2,1560,1547,4,13,1
68,1,1526,1542,1,16,1
100,1,1517,1531,4,14,1
91,2,1520,1521,6,1,0
81,2,1511,1418,5,93,1
193,2,1501,1447,2,54,1
112,1,1519,1306,8,213,0
69,2,1513,1350,5,163,1
119,2,1501,1499,5,2,1
123,2,1486,1568,9,82,0
26,1,1501,1404,7,97,0
128,1,1519,1330,3,189,0
96,1,1536,1399,4,137,0
29,2,1533,1131,5,402,1
135,2,1524,1448,1,76,1
47,2,1515,1421,4,94,1
23,2,1510,1283,5,227,1
77,2,1498,1537,4,39,0
47,2,1489,1500,4,11,0
82,1,1361,1481,3,120,1
39,2,1470,1438,6,32,1
31,1,1481,1515,2,34,1
53,2,1772,1485,4,287,1
46,2,1475,1387,1,88,1
50,1,1301,1468,3,167,1
11,2,1213,1489,4,276,0
32,1,1502,1318,4,184,0
50,1,1522,1289,6,233,0
57,2,1352,1541,3,189,0
27,2,1392,1254,7,138,1
57,2,1535,1318,2,217,1
89,2,1338,1539,2,201,0
58,1,2096,1901,5,195,0
68,1,1920,2087,5,167,1
54,1,2004,2073,8,69,1
113,2,2084,2066,10,18,1
149,2,2074,1908,4,166,1
64,1,1788,2067,5,279,1
59,2,2060,1792,7,268,1
74,1,1819,2052,6,233,1
47,2,2047,1710,8,337,1
117,2,2136,2062,4,74,1
30,1,2081,2096,4,15,1
59,2,2063,2027,4,36,1
117,2,2048,1924,6,124,1
31,2,1804,1997,9,193,0
55,2,2051,2072,6,21,0
67,2,2057,1923,6,134,1
82,1,1922,2040,9,118,1
144,0,2063,2038,8,25,0
53,2,2003,2078,5,75,0
52,2,1996,1618,5,378,1
138,0,1804,2013,4,209,0
46,1,1834,1994,8,160,1
85,1,1867,1968,11,101,1
43,2,1653,1711,4,58,0
85,1,1663,1706,6,43,1
49,2,1692,1674,3,18,1
91,2,1709,1685,6,24,1
69,2,1631,1698,3,67,0
87,1,1708,1772,4,64,1
114,1,1724,1545,5,179,0
56,1,1723,1713,3,10,0
34,1,1642,1703,2,61,1
49,2,1689,1770,5,81,0
59,2,1763,1698,2,65,1
86,2,1693,1477,5,216,1
85,2,1664,1706,8,42,0
70,1,1500,1701,3,201,1
38,1,1704,1689,4,15,0
46,1,1680,1677,2,3,0
51,2,1757,1687,4,70,1
74,1,1666,1675,3,9,1
113,2,1663,1667,6,4,0
13,2,1651,1641,5,10,1
46,1,1654,1638,3,16,0
29,1,1680,1623,5,57,0
59,2,1610,1617,7,7,0
79,2,1754,1618,6,136,1
78,1,1713,1602,2,111,0
36,1,1795,1581,3,214,0
39,1,1658,1565,5,93,0
79,2,1721,1573,9,148,1
73,2,1557,1614,9,57,0
34,1,1423,1500,8,77,1
66,1,1566,1694,6,128,1
22,1,1432,1493,7,61,1
39,2,1656,1577,2,79,1
25,2,1557,1713,6,156,0
51,2,1686,1567,5,119,1
95,2,1606,1579,3,27,1
45,2,1519,1597,3,78,0
102,1,1619,1452,2,167,0
35,2,1610,1500,6,110,1
33,2,1612,1626,9,14,0
56,1,1633,1610,3,23,0
117,2,1595,1583,5,12,1
63,2,1696,1607,9,89,1
62,1,1743,1586,3,157,0
66,0,1630,1584,3,46,0
50,1,1609,1564,7,45,0
113,2,1508,1586,3,78,0
97,2,1573,1465,4,108,1
132,1,1459,1494,4,35,1
24,1,1061,1133,3,72,1
82,1,1210,1151,3,59,0
13,2,1812,1797,4,15,1
66,1,1628,1581,8,47,0
99,2,1577,1571,4,6,1
54,1,1638,1497,5,141,0
46,2,1605,1403,6,202,1
90,1,1705,1348,2,357,0
42,2,1691,1335,4,356,1
58,1,1253,1679,2,426,1
53,2,1238,1811,6,573,0
47,2,1806,1199,5,607,1
54,1,1200,1802,2,602,1
104,1,1258,1793,3,535,1
99,0,1706,1287,8,419,0
81,2,1782,1325,7,457,1
57,2,1770,1321,4,449,1
58,1,1387,1739,2,352,1
33,2,1697,1405,5,292,1
65,2,1687,1108,4,579,1
80,1,1200,1670,2,470,1
33,2,1624,1620,9,4,1
6,1,1325,1620,4,295,1
71,2,1677,1620,9,57,1
65,2,1595,1416,3,179,1
94,1,1292,1500,1,208,1
86,1,1325,1087,1,238,0
46,1,1033,1263,2,230,1
172,1,1500,1501,2,1,1
47,2,1521,1500,2,21,1
84,1,1490,1672,6,182,1
34,1,828,1192,1,364,1
7,2,1245,906,3,339,1
5,2,1090,837,2,253,1
15,2,1576,910,1,666,1
44,1,838,1642,1,804,1
39,2,1317,920,2,397,1
53,2,1500,850,3,650,1
19,2,1497,924,2,573,1
9,2,1500,848,2,652,1
7,2,1129,954,2,175,1
44,1,996,1108,2,112,1
2,1,1233,1391,2,158,1
30,1,1260,1211,3,49,0
2,1,1300,1064,2,236,0
75,2,1344,1325,3,19,1
80,1,1350,1566,3,216,1
34,1,1367,1533,6,166,1
29,2,1526,1388,9,138,1
14,0,1373,1530,6,157,0
17,0,1365,1445,2,80,0
24,1,1180,1341,3,161,1
76,2,1310,1189,3,121,1
63,2,1763,1318,4,445,1
115,2,1582,1769,3,187,0
92,1,1375,1473,3,98,1
75,2,1300,1375,4,75,0
62,1,1368,1484,5,116,1
57,2,1484,1303,4,181,1
43,2,1368,1484,4,116,0
2,1,1720,1500,2,220,0
2,2,1461,828,2,633,1
2,1,830,1460,2,630,1
2,2,1459,832,2,627,1
2,2,1442,834,2,608,1
2,1,835,1754,2,919,1
2,2,1376,838,1,538,1
2,1,842,1374,1,532,1
2,2,1373,846,1,527,1
2,1,850,1371,2,521,1
2,2,1369,854,1,515,1
2,1,858,1368,1,510,1
2,2,1366,863,1,503,1
2,1,868,1364,1,496,1
2,2,1362,873,1,489,1
2,1,878,1361,2,483,1
2,2,1359,884,1,475,1
2,1,890,1357,2,467,1
2,2,1355,897,2,458,1
2,1,904,1353,2,449,1
2,2,1351,912,2,439,1
2,1,920,1348,2,428,1
2,2,1346,930,1,416,1
2,1,940,1343,2,403,1
2,2,1341,952,1,389,1
2,1,965,1338,2,373,1
2,2,1335,981,2,354,1
2,1,981,1335,2,354,1
2,2,1332,1001,2,331,1
2,1,1025,1328,2,303,1
2,2,1324,1058,2,266,1
2,1,1106,1319,2,213,1
2,2,1319,1106,2,213,1
2,1,1197,1312,2,115,1
2,2,1302,1500,2,198,0
80,1,1420,1443,6,23,1
75,2,1429,1461,4,32,0
94,1,1384,1447,8,63,1
37,2,1490,1463,9,27,1
48,2,1370,1487,4,117,0
82,2,1464,1425,3,39,1
144,1,1506,1294,3,212,0
77,2,1499,1364,3,135,1
159,2,1487,1527,3,40,0
77,2,1476,1452,2,24,1
81,2,1467,1408,2,59,1
56,1,1489,1453,2,36,0
83,2,1510,1346,3,164,1
28,1,1206,1517,6,311,1
45,2,1487,1542,2,55,0
55,2,1524,1436,4,88,1
133,2,1519,1288,2,231,1
158,1,1545,1498,2,47,0
63,2,1538,1423,3,115,1
56,1,1568,1408,4,160,0
87,2,1563,1351,3,212,1
29,2,1554,1479,2,75,1
49,2,1559,1451,3,108,1
17,2,1551,1459,3,92,1
61,2,1558,1414,4,144,1
75,2,1544,1354,3,190,1
64,2,1535,1447,2,88,1
88,1,1568,1469,2,99,0
40,1,1583,1461,2,122,0
61,2,1571,1437,2,134,1
15,2,1565,1393,3,172,1
66,1,1566,1317,4,249,0
83,2,1558,1389,3,169,1
66,2,1547,1543,2,4,1
74,1,1560,1531,1,29,0
141,0,1562,1493,3,69,0
54,1,1487,1107,3,380,0
122,1,1248,1500,4,252,1
58,1,1310,1304,2,6,0
105,0,1500,1202,2,298,0
38,1,1689,1432,6,257,0
68,1,1528,1500,2,28,0
63,2,1447,1389,3,58,1
59,2,1278,1104,6,174,1
72,1,1403,1291,2,112,0
53,2,1387,1562,2,175,0
14,0,1344,1388,3,44,0
19,2,1412,1399,6,13,1
116,1,1403,1387,3,16,0
49,2,1321,1401,5,80,0
114,1,1368,1391,4,23,1
57,1,1404,1346,2,58,0
36,1,1408,1652,2,244,1
19,2,1488,1417,6,71,1
101,2,1404,1476,2,72,0
58,1,1331,1270,4,61,0
95,2,1447,1413,7,34,1
71,2,1506,1422,4,84,1
118,1,1451,1409,6,42,0
52,1,1465,1396,3,69,0
23,2,1198,1413,3,215,0
72,1,1425,1387,4,38,0
62,1,1435,1481,3,46,1
103,2,1424,1425,2,1,0
112,1,1432,1513,3,81,1
80,1,1336,1424,6,88,1
26,1,1444,1412,8,32,0
61,2,1570,1419,4,151,1
93,0,1511,1416,6,95,0
18,1,1521,1401,4,120,0
39,0,1377,1402,4,25,0
22,1,1437,1389,6,48,0
3,2,1427,1399,3,28,1
44,1,1404,1631,2,227,1
76,1,1610,1388,7,222,0
72,1,1393,1589,3,196,1
52,1,1389,1788,2,399,1
37,2,1640,1393,6,247,1
8,1,1404,1390,2,14,0
84,1,1293,1390,6,97,1
103,2,1268,1405,3,137,0
33,2,1908,1479,3,429,1
13,0,1364,2081,3,717,0
24,2,1788,1245,5,543,1
35,2,1245,1011,1,234,1
20,1,1245,1148,5,97,0
95,0,1148,1245,4,97,0
56,1,1930,2068,15,138,1
75,1,1913,2042,5,129,1
36,1,1921,2009,8,88,1
24,1,1152,1550,4,398,1
83,2,1967,1152,6,815,1
55,2,1619,1155,5,464,1
96,1,1159,1501,5,342,1
93,2,1146,1055,4,91,1
46,2,1562,1149,2,413,1
12,2,1195,1000,1,195,1
8,0,1176,1148,3,28,0
33,2,1099,1166,4,67,0
4,2,1282,1180,3,102,1
11,2,1274,1194,4,80,1
9,2,1457,1202,4,255,1
11,2,1510,1208,1,302,1
21,2,1508,1214,4,294,1
13,2,1283,1232,4,51,1
40,1,1257,1199,2,58,0
54,1,1290,1119,2,171,0
16,2,1885,1291,4,594,1
11,2,1375,1311,4,64,1
73,1,1331,1394,3,63,1
8,1,1339,1646,2,307,1
24,1,1377,1418,3,41,1
17,2,1860,1381,4,479,1
15,2,1661,1392,2,269,1
24,1,1165,1765,2,600,1
29,2,1670,1432,4,238,1
57,2,1290,1449,5,159,0
19,2,1442,1297,9,145,1
63,2,1478,1453,3,25,1
64,1,1759,1438,8,321,0
23,2,1426,1408,9,18,1
100,1,1409,1790,3,381,1
2,2,1409,1723,2,314,0
64,1,1423,1552,3,129,1
85,2,1711,1427,5,284,1
53,2,1626,1433,2,193,1
88,1,1252,1427,6,175,1
17,0,1423,1744,3,321,0
41,2,1775,1426,4,349,1
46,1,1431,1658,4,227,1
61,2,1578,1438,5,140,1
93,2,1507,1448,5,59,1
29,1,1456,1562,4,106,1
51,2,1402,1462,7,60,0
62,1,1469,1636,8,167,1
59,2,1449,1731,8,282,0
39,2,1436,1478,7,42,0
118,0,1787,1427,5,360,0
104,2,1501,1436,4,65,1
24,1,1439,1821,3,382,1
58,1,1419,1428,5,9,1
73,1,1435,1598,6,163,1
41,2,1497,1445,3,52,1
10,2,1531,1454,7,77,1
35,2,1439,1545,3,106,0
21,2,1567,1447,4,120,1
47,2,1953,1448,6,505,1
91,2,1553,1457,5,96,1
41,1,1462,1697,4,235,1
159,1,1526,1447,5,79,0
53,2,1431,1539,6,108,0
96,1,1435,1725,4,290,1
19,2,1583,1426,4,157,1
102,2,1694,1430,8,264,1
67,0,1420,1886,2,466,0
26,2,1436,1432,5,4,1
141,0,1428,1531,3,103,0
131,2,1726,1432,5,294,1
78,2,1627,1438,8,189,1
58,2,1889,1440,9,449,1
63,2,1427,1447,2,20,0
22,1,842,1076,1,234,1
35,2,1076,842,2,234,1
19,2,966,869,3,97,1
9,0,1017,869,2,148,0
16,1,869,1028,2,159,1
45,2,1028,869,4,159,1
10,1,869,1028,1,159,1
21,2,1028,869,2,159,1
21,2,1015,897,2,118,1
4,1,927,1055,1,128,1
87,2,1507,927,2,580,1
65,2,1665,927,2,738,1
39,1,1435,1653,1,218,1
38,1,1397,1500,1,103,1
3,2,1828,1500,2,328,1
30,1,1303,1500,2,197,1
29,1,1247,1224,8,23,0
35,2,1311,1320,6,9,0
39,2,1398,1412,7,14,0
51,2,1348,1183,2,165,1
84,1,1170,800,4,370,0
27,2,1381,1575,10,194,0
43,2,1500,1219,6,281,1
19,2,899,1139,4,240,0
27,2,1224,1289,5,65,0
40,2,1207,1367,4,160,0
89,2,1359,1214,5,145,1
22,1,1340,1197,3,143,0
84,1,1207,1232,5,25,1
55,2,1082,1500,5,418,0
33,2,1429,1212,4,217,1
65,2,1177,1217,4,40,0
32,1,1231,1162,4,69,0
28,1,1173,1221,4,48,1
52,1,1235,1157,4,78,0
49,2,1253,1247,1,6,1
69,2,1044,1181,7,137,0
83,2,1391,1263,7,128,1
114,0,1231,1264,4,33,0
126,1,1305,1250,2,55,0
30,1,1415,1245,4,170,0
78,1,1401,1237,3,164,0
49,2,1399,1238,4,161,1
101,2,1400,1246,3,154,1
51,2,1232,1266,4,34,0
73,2,1215,1326,4,111,0
66,1,1320,1198,4,122,0
84,1,1364,1182,5,182,0
46,1,1197,1151,4,46,0
85,2,1197,1023,4,174,1
55,2,1171,1070,4,101,1
51,2,1185,1125,4,60,1
93,2,1170,1192,3,22,0
31,2,1155,1170,4,15,0
51,2,1500,1410,6,90,1
54,1,1607,1580,4,27,0
38,1,1739,1606,6,133,0
30,1,1487,1673,3,186,1
98,1,1496,1500,5,4,1
50,1,1622,1500,6,122,0
23,2,1500,1568,6,68,0
56,1,1502,1500,7,2,0
33,0,1375,1500,4,125,0
48,2,1500,1575,7,75,0
68,1,1197,1500,8,303,1
37,2,1500,1370,8,130,1
75,2,1565,1549,3,16,1
34,1,1320,1554,2,234,1
57,2,1525,1524,8,1,1
68,1,1497,1493,14,4,0
54,1,1259,1478,4,219,1
60,1,1665,1421,7,244,0
48,2,1390,1319,2,71,1
75,1,1329,1350,5,21,1
30,1,1005,1350,5,345,1
113,2,1308,1205,3,103,1
55,2,1286,1280,1,6,1
75,2,1260,1313,1,53,0
78,1,1327,1490,3,163,1
20,1,1299,1301,4,2,1
62,1,1314,1520,5,206,1
48,1,1211,1500,1,289,1
66,1,1576,1256,4,320,0
75,2,2003,1316,2,687,1
62,1,1359,1170,4,189,0
44,1,1219,1339,1,120,1
39,2,1303,1353,7,50,0
94,1,1381,1256,4,125,0
41,2,1373,1271,3,102,1
6,1,1306,1396,2,90,1
68,1,1312,1814,5,502,1
55,2,1282,1129,1,153,1
101,2,1466,1318,3,148,1
34,1,1337,1672,3,335,1
21,2,1668,1360,5,308,1
82,1,1453,1427,5,26,0
51,2,2117,1458,9,659,1
48,1,1498,1276,7,222,0
13,2,1500,1350,5,150,1
75,2,1459,1500,3,41,0
35,2,1449,1462,4,13,0
108,1,1472,1501,5,29,1
144,1,1481,1516,3,35,1
53,2,1472,1435,3,37,1
52,1,1483,1455,8,28,0
59,2,1401,1496,3,95,0
78,1,1456,1487,3,31,1
74,1,1548,1476,2,72,0
104,1,1486,1484,4,2,0
82,1,1401,1478,4,77,1
88,1,1532,1466,4,66,0
61,2,1456,1441,6,15,1
73,2,1445,1454,6,9,0
77,2,1509,1454,2,55,1
122,0,1442,1454,3,12,0
157,2,1440,1465,3,25,0
67,2,1500,1472,12,28,1
23,2,1464,1362,6,102,1
50,1,1475,1462,3,13,0
49,2,1457,1487,10,30,0
33,2,1478,1422,7,56,1
89,2,1507,1488,3,19,1
37,2,1540,1489,9,51,1
110,1,1499,1486,1,13,0
46,1,1509,1540,6,31,1
77,2,1487,1521,1,34,0
18,1,1477,1504,4,27,1
117,0,1402,1507,3,105,0
55,2,1498,1446,3,52,1
72,1,1505,1628,6,123,1
58,1,1510,1480,6,30,0
75,2,1502,1394,3,108,1
14,1,1455,1493,2,38,1
34,1,1507,1482,3,25,0
48,1,1434,1473,5,39,1
110,1,1475,1470,3,5,0
54,1,1487,1427,5,60,0
35,2,1500,1487,2,13,1
37,2,1478,1423,5,55,1
52,1,1504,1467,2,37,0
71,2,1457,1448,5,9,1
151,2,1462,1468,3,6,0
60,1,1480,1419,8,61,0
86,1,1391,1472,4,81,1
77,2,1462,1424,5,38,1
8,2,1551,1159,2,392,1
62,1,1057,1450,3,393,1
37,2,1577,1217,2,360,1
130,0,1272,1186,1,86,0
32,1,1337,1391,3,54,1
19,2,1500,1500,3,0,0
54,1,1500,1099,4,401,0
67,2,1277,1500,2,223,0
175,2,1896,1619,4,277,1
55,2,1481,1750,9,269,0
47,2,1426,1458,18,32,0
52,1,1512,1485,7,27,0
137,0,1503,1637,5,134,0
147,2,1629,1510,5,119,1
48,0,1506,1633,5,127,0
60,1,1524,1765,8,241,1
131,2,1760,1529,6,231,1
42,1,1534,1755,9,221,1
56,2,1533,1593,7,60,0
37,1,1547,1356,9,191,0
55,2,1537,1560,8,23,0
36,1,1564,1814,4,250,1
23,2,1548,1729,8,181,0
40,1,1563,1469,3,94,0
85,2,1551,1573,4,22,0
48,2,1549,1109,4,440,1
7,2,1536,1232,4,304,1
35,2,1518,1762,7,244,0
19,1,1500,1337,10,163,0
56,2,1514,1255,7,259,1
100,1,1260,1389,7,129,1
46,1,1389,1260,7,129,0
65,2,1509,1253,5,256,1
48,1,1520,1534,12,14,1
25,2,1509,1499,7,10,1
39,2,1506,1133,5,373,1
177,0,1502,1718,6,216,0
88,1,1509,1639,6,130,1
53,2,1500,1451,5,49,1
16,1,1512,1503,4,9,0
29,2,1489,1589,2,100,0
28,1,1496,1646,7,150,1
56,1,1507,1512,3,5,1
73,1,1517,1569,4,52,1
70,1,1524,1668,7,144,1
49,2,1515,1437,5,78,1
7,2,1508,1373,6,135,1
44,1,1522,1461,7,61,0
98,0,1523,1494,7,29,0
61,1,1536,1487,5,49,0
50,1,1542,1763,4,221,1
57,2,1524,1714,5,190,0
39,2,1521,1150,4,371,1
42,1,1540,1267,4,273,0
28,1,1549,1647,8,98,1
81,2,1976,1755,8,221,1
66,1,1768,1662,6,106,0
132,1,1500,1652,4,152,1
59,2,1398,1500,3,102,0
41,2,1500,1500,3,0,0
42,1,1400,1500,3,100,1
85,2,1452,1500,5,48,0
37,0,1458,1500,4,42,0
51,2,1906,1857,6,49,1
73,2,1897,1027,8,870,1
81,2,1500,1814,8,314,0
37,2,1456,1193,5,263,1
46,1,1231,1177,3,54,0
94,1,1777,1640,9,137,0
85,2,1944,1674,4,270,1
95,2,1777,1785,5,8,0
106,1,1726,1560,5,166,0
58,1,1151,1500,3,349,1
10,2,1381,1500,3,119,0
14,2,1646,1381,4,265,1
48,1,1500,1637,4,137,1
38,1,1972,2174,4,202,1
85,2,1603,1641,1,38,0
68,1,1647,1805,3,158,1
13,2,1798,1654,3,144,1
101,2,1617,1666,1,49,0
58,1,1383,1662,4,279,1
54,1,1567,1655,4,88,1
72,1,1754,1641,1,113,0
73,2,1809,1647,4,162,1
86,1,1576,1638,3,62,1
118,0,1437,1634,3,197,0
54,1,1652,1622,1,30,0
134,1,1566,1612,4,46,1
96,2,1604,1523,3,81,1
70,1,1532,1595,3,63,1
51,2,1735,1602,4,133,1
75,1,1508,1594,3,86,1
45,2,1645,1603,4,42,1
63,2,2222,1604,1,618,1
75,2,1666,1613,4,53,1
56,1,1597,1603,3,6,1
50,1,1582,1592,1,10,1
66,1,1537,1583,4,46,1
87,2,1704,1590,1,114,1
47,2,1612,1601,4,11,1
37,2,1692,1609,3,83,1
138,1,1650,1597,4,53,0
35,2,1816,1602,6,214,1
74,1,1617,1593,3,24,0
48,1,1563,1583,3,20,1
46,1,1492,1574,4,82,1
84,1,1589,1563,4,26,0
22,1,1717,1547,3,170,0
40,1,1372,1410,4,38,1
89,2,1566,1558,1,8,1
70,1,1375,1410,4,35,1
82,1,1500,1551,1,51,1
56,1,1558,1674,5,116,1
141,2,1666,1566,3,100,1
89,2,1594,1576,3,18,1
82,1,1614,1564,4,50,0
94,1,1535,1555,4,20,1
46,1,1645,1541,1,104,0
55,2,1696,1548,1,148,1
124,1,1486,1539,3,53,1
45,2,1557,1549,3,8,1
89,2,1577,1559,3,18,1
112,1,1570,1566,1,4,0
116,1,1578,1559,1,19,0
53,2,1484,1500,5,16,0
30,2,2179,1593,5,586,1
94,1,1698,1612,2,86,0
74,2,1870,1676,4,194,1
50,1,1502,1500,2,2,0
73,2,1432,1500,4,68,0
58,1,1500,1629,4,129,1
54,1,1396,1500,5,104,1
43,1,1607,1500,5,107,0
54,1,1530,1500,5,30,0
60,1,1306,1500,4,194,1
34,1,1626,1500,9,126,0
67,2,1500,1626,6,126,0
44,1,1584,1500,7,84,0
25,2,1500,1584,9,84,0
52,1,1229,1500,1,271,1
41,2,1500,1229,16,271,1
44,1,1434,1538,1,104,1
69,2,1533,1586,1,53,0
44,1,1678,1416,6,262,0
65,2,1550,1564,3,14,0
50,1,1169,1500,7,331,1
44,1,1500,1500,3,0,0
116,1,1302,1611,2,309,1
69,2,1598,1359,2,239,1
80,1,1500,1581,7,81,1
46,1,1280,1500,3,220,1
39,2,1500,1280,2,220,1
15,2,1673,1500,3,173,1
23,2,1356,1135,2,221,1
59,2,1349,1141,3,208,1
56,1,1148,1336,1,188,1
3,1,1500,1133,2,367,0
52,1,1138,1377,1,239,1
68,1,1144,1372,1,228,1
2,1,1146,1572,1,426,1
37,2,1491,1150,2,341,1
33,2,1453,1154,2,299,1
38,1,1161,1341,1,180,1
35,2,1854,1162,3,692,1
74,0,1357,1155,3,202,0
95,2,1620,1157,2,463,1
45,1,1164,1345,1,181,1
76,1,1168,1468,1,300,1
27,2,1573,1170,3,403,1
81,2,1242,1181,1,61,1
50,1,1196,1130,1,66,0
27,1,1199,1591,1,392,1
38,1,1201,1632,1,431,1
8,1,969,1195,3,226,1
7,2,1178,1339,1,161,0
37,2,1468,1182,3,286,1
92,1,1191,1303,1,112,1
55,2,1294,1201,3,93,1
12,1,1252,1187,3,65,0
95,2,1378,1194,1,184,1
110,1,1431,1173,3,258,0
103,2,1203,1185,3,18,1
71,2,1236,1197,4,39,1
122,1,1024,1152,1,128,1
40,1,1160,1303,1,143,1
45,2,1278,1057,2,221,1
35,2,1148,1114,1,34,1
86,1,1327,1126,2,201,0
55,2,1632,1128,4,504,1
39,1,1414,1104,2,310,0
61,2,1347,1110,3,237,1
82,1,957,1101,2,144,1
19,2,1300,1108,2,192,1
12,1,1116,1292,1,176,1
21,2,1569,1108,3,461,1
60,1,1111,1521,1,410,1
35,2,1312,1118,3,194,1
21,2,1567,1120,3,447,1
53,2,1905,1843,2,62,1
40,1,1852,1896,2,44,1
59,2,1888,1793,4,95,1
43,2,1879,1826,12,53,1
43,2,1921,1889,2,32,1
63,2,1881,1777,4,104,1
57,2,1823,1894,3,71,0
91,2,1891,1904,3,13,0
61,2,1895,1858,3,37,1
103,2,1879,1906,2,27,0
57,2,1882,1959,3,77,0
60,1,1896,1871,7,25,0
142,1,2072,1855,2,217,0
99,2,1788,1868,4,80,0
45,2,1856,1895,12,39,0
72,1,1756,1849,3,93,1
53,2,1839,1805,5,34,1
61,1,1812,1829,3,17,1
50,1,1841,1801,3,40,0
73,2,1833,1752,7,81,1
85,2,2069,1837,5,232,1
69,2,1953,1844,5,109,1
43,2,1838,1979,2,141,0
73,2,1976,1845,3,131,1
59,2,1835,1812,3,23,1
73,2,1826,1792,7,34,1
36,1,1835,1887,6,52,1
99,2,2121,1838,2,283,1
78,1,1752,1830,1,78,1
67,2,1816,1841,3,25,0
89,2,1837,1852,4,15,0
87,2,1844,1769,4,75,1
111,2,1926,1852,5,74,1
66,1,1791,1843,1,52,1
71,2,2093,1854,6,239,1
72,1,1619,2145,2,526,1
60,1,1497,2129,8,632,1
58,1,2096,1901,5,195,0
68,1,1920,2087,5,167,1
54,1,2004,2073,8,69,1
113,2,2084,2066,10,18,1
149,2,2074,1908,4,166,1
64,1,1788,2067,5,279,1
59,2,2060,1792,7,268,1
74,1,1819,2052,6,233,1
47,2,2047,1710,8,337,1
117,2,2136,2062,4,74,1
30,1,2081,2096,4,15,1
59,2,2063,2027,4,36,1
117,2,2048,1924,6,124,1
31,2,1804,1997,9,193,0
55,2,2051,2072,6,21,0
67,2,2057,1923,6,134,1
82,1,1922,2040,9,118,1
144,0,2063,2038,8,25,0
53,2,2003,2078,5,75,0
52,2,1996,1618,5,378,1
138,0,1804,2013,4,209,0
46,1,1834,1994,8,160,1
85,1,1867,1968,11,101,1
43,2,1653,1711,4,58,0
85,1,1663,1706,6,43,1
49,2,1692,1674,3,18,1
91,2,1709,1685,6,24,1
69,2,1631,1698,3,67,0
87,1,1708,1772,4,64,1
114,1,1724,1545,5,179,0
56,1,1723,1713,3,10,0
34,1,1642,1703,2,61,1
49,2,1689,1770,5,81,0
59,2,1763,1698,2,65,1
86,2,1693,1477,5,216,1
85,2,1664,1706,8,42,0
70,1,1500,1701,3,201,1
38,1,1704,1689,4,15,0
46,1,1680,1677,2,3,0
51,2,1757,1687,4,70,1
74,1,1666,1675,3,9,1
113,2,1663,1667,6,4,0
13,2,1651,1641,5,10,1
46,1,1654,1638,3,16,0
29,1,1680,1623,5,57,0
59,2,1610,1617,7,7,0
79,2,1754,1618,6,136,1
78,1,1713,1602,2,111,0
36,1,1795,1581,3,214,0
39,1,1658,1565,5,93,0
79,2,1721,1573,9,148,1
73,2,1557,1614,9,57,0
34,1,1423,1500,8,77,1
66,1,1566,1694,6,128,1
22,1,1432,1493,7,61,1
39,2,1656,1577,2,79,1
25,2,1557,1713,6,156,0
51,2,1686,1567,5,119,1
95,2,1606,1579,3,27,1
45,2,1519,1597,3,78,0
102,1,1619,1452,2,167,0
35,2,1610,1500,6,110,1
33,2,1612,1626,9,14,0
56,1,1633,1610,3,23,0
117,2,1595,1583,5,12,1
63,2,1696,1607,9,89,1
62,1,1743,1586,3,157,0
66,0,1630,1584,3,46,0
50,1,1609,1564,7,45,0
113,2,1508,1586,3,78,0
97,2,1573,1465,4,108,1
132,1,1459,1494,4,35,1
24,1,1061,1133,3,72,1
82,1,1210,1151,3,59,0
13,2,1812,1797,4,15,1
66,1,1628,1581,8,47,0
99,2,1577,1571,4,6,1
54,1,1638,1497,5,141,0
46,2,1605,1403,6,202,1
90,1,1705,1348,2,357,0
42,2,1691,1335,4,356,1
58,1,1253,1679,2,426,1
53,2,1238,1811,6,573,0
47,2,1806,1199,5,607,1
54,1,1200,1802,2,602,1
104,1,1258,1793,3,535,1
99,0,1706,1287,8,419,0
81,2,1782,1325,7,457,1
57,2,1770,1321,4,449,1
58,1,1387,1739,2,352,1
33,2,1697,1405,5,292,1
65,2,1687,1108,4,579,1
80,1,1200,1670,2,470,1
33,2,1624,1620,9,4,1
6,1,1325,1620,4,295,1
71,2,1677,1620,9,57,1
65,2,1595,1416,3,179,1
94,1,1292,1500,1,208,1
61,2,1439,1454,3,15,0
95,2,1523,1469,5,54,1
59,2,1724,1721,9,3,1
47,2,1687,1763,10,76,0
119,2,1732,1700,6,32,1
41,2,1746,1772,3,26,0
81,0,1773,1768,6,5,0
116,1,1624,1741,3,117,1
99,0,1772,1537,10,235,0
77,2,1783,1841,5,58,0
81,2,1811,1581,5,230,1
96,0,1733,1833,4,100,0
10,2,1625,1833,2,208,0
98,1,1460,1808,10,348,1
18,1,1679,1695,1,16,1
95,2,1500,1539,3,39,0
32,1,1336,1275,3,61,0
43,1,1295,1311,6,16,1
81,1,1325,1379,6,54,1
31,2,1302,1293,6,9,1
27,2,1431,1320,6,111,1
42,2,1333,1347,3,14,0
46,2,1345,1340,7,5,1
124,1,1444,1300,7,144,0
46,1,1331,1374,2,43,1
85,2,1387,1368,2,19,1
39,2,1419,1425,4,6,0
38,1,1263,1387,4,124,1
53,2,1433,1458,5,25,0
63,2,1372,1393,5,21,0
37,2,1332,1081,8,251,1
114,0,1309,1375,5,66,0
52,1,2175,2208,14,33,1
7,0,2208,1500,6,708,0
56,0,2208,2526,10,318,0
62,1,1348,2208,2,860,1
69,2,2207,1634,7,573,1
189,2,2206,1723,9,483,1
64,1,1725,2204,11,479,1
77,2,2201,1849,3,352,1
29,2,2192,2063,6,129,1
86,1,1902,2188,10,286,1
78,1,1620,2187,2,567,1
22,0,2189,2123,11,66,0
117,2,2182,1999,8,183,1
168,1,2188,2168,15,20,0
27,2,1823,1600,5,223,1
66,1,1909,1639,3,270,0
61,2,1853,1923,1,70,0
69,2,2121,1929,9,192,1
74,1,1935,2124,7,189,1
94,1,1916,1924,5,8,1
75,2,1916,1791,4,125,1
92,1,1931,1749,3,182,0
76,1,1643,1927,1,284,1
58,2,1801,1943,9,142,0
119,2,1942,1466,8,476,1
70,1,1957,1820,7,137,0
121,2,1933,1970,4,37,0
75,2,2016,1980,2,36,1
109,2,1969,1971,6,2,0
87,2,2168,1975,11,193,1
77,2,1968,1817,2,151,1
87,2,1961,1805,12,156,1
91,2,1746,1979,5,233,0
50,1,1878,1971,8,93,1
29,2,2086,1979,8,107,1
117,1,1992,1941,5,51,0
47,2,1981,1977,4,4,1
150,1,1880,1972,2,92,1
10,2,1971,1244,7,727,1
108,1,1452,1970,3,518,1
42,1,1976,2152,5,176,1
87,2,1970,1785,5,185,1
69,2,2107,1978,3,129,1
94,1,1981,2303,5,322,1
56,1,1941,1971,4,30,1
47,2,1953,2149,12,196,0
113,2,2287,1956,10,331,1
71,2,1929,1876,6,53,1
68,1,1892,1761,5,131,0
28,1,1898,2055,6,157,1
93,2,1886,1906,3,20,0
56,1,1768,1878,5,110,1
31,2,1696,1896,6,200,0
89,0,2160,1888,6,272,0
71,2,1881,1737,2,144,1
64,1,1888,1875,5,13,0
64,1,1886,1876,2,10,0
59,2,1777,1867,7,90,0
63,1,1626,1862,2,236,1
69,2,1844,2056,13,212,0
45,1,1810,1700,9,110,0
25,2,2277,1810,10,467,1
104,1,1389,1307,5,82,0
33,2,1678,1299,10,379,1
64,1,1152,1299,3,147,1
62,1,1303,1634,6,331,1
47,2,1278,1530,6,252,0
30,2,1595,1281,6,314,1
24,2,1267,1344,8,77,0
20,2,1332,1277,8,55,1
66,1,1213,1277,8,64,1
12,1,1277,1047,3,230,0
63,1,1047,1277,3,230,1
82,2,1393,1285,3,108,1
87,2,1279,1090,2,189,1
19,2,1268,1255,4,13,1
59,2,1186,1283,3,97,0
124,1,1283,1267,5,16,0
96,1,1290,1270,1,20,0
53,2,1331,1281,4,50,1
39,2,1304,1292,1,12,1
10,1,1305,1293,3,12,0
51,2,1308,1317,8,9,0
18,1,1296,1305,13,9,1
106,1,968,1305,8,337,1
38,1,1293,1466,5,173,1
59,2,1500,1299,7,201,1
111,2,1288,1232,3,56,1
28,1,1289,2108,9,819,1
101,2,1431,1289,6,142,1
15,2,1806,1289,7,517,1
42,2,1289,1311,5,22,0
118,1,1431,1289,3,142,0
34,1,1289,1484,6,195,1
60,1,1289,1810,5,521,1
66,1,1806,1289,5,517,0
21,2,1289,1500,5,211,0
73,2,1409,1297,8,112,1
159,2,1280,1485,6,205,0
74,2,1280,1211,4,69,1
28,1,1211,1280,3,69,1
112,1,1281,1765,6,484,1
31,2,1893,1899,5,6,0
63,2,1743,1910,4,167,0
111,1,1990,1901,4,89,0
42,1,1912,1958,13,46,1
39,2,1947,1923,17,24,1
121,2,1919,1640,7,279,1
12,1,1681,1914,4,233,1
47,2,1904,1841,2,63,1
15,2,1903,1183,7,720,1
115,2,1015,1818,4,803,0
97,2,1818,1015,4,803,1
54,1,1015,1779,6,764,1
70,1,1779,1015,5,764,0
31,1,1015,1779,4,764,1
60,1,1682,1015,8,667,0
97,2,2305,1015,6,1290,1
22,1,1015,2305,11,1290,1
69,2,972,1484,3,512,0
101,2,928,1442,5,514,0
57,2,884,1415,2,531,0
76,1,1187,845,3,342,0
120,1,1450,789,3,661,0
2,1,784,1006,2,222,1
2,2,827,806,2,21,1
2,2,1025,818,2,207,1
2,2,1027,831,2,196,1
2,1,837,1216,2,379,1
2,1,844,1214,2,370,1
2,1,844,1500,2,656,1
2,2,1500,844,2,656,1
2,1,844,1500,2,656,1
2,2,1454,845,2,609,1
2,2,1500,845,2,655,1
2,1,856,1121,2,265,1
2,1,889,850,2,39,0
3,2,833,930,2,97,0
2,2,955,965,2,10,0
2,1,1004,999,2,5,0
2,1,1042,1083,2,41,1
2,2,1245,1069,2,176,1
3,2,1121,1123,3,2,0
3,2,1184,1187,3,3,0
2,1,1253,1300,2,47,1
3,2,1418,1271,3,147,1
3,2,1405,1500,3,95,0
66,0,1500,2305,6,805,0
65,2,1508,1443,3,65,1
57,2,1158,1155,7,3,1
100,0,1158,1158,3,0,0
23,2,1158,1324,8,166,0
31,1,1158,1324,8,166,1
7,2,1324,1158,5,166,1
6,1,1158,1324,5,166,1
26,1,1101,1148,7,47,1
16,1,1159,1165,8,6,1
14,1,1166,1295,8,129,1
78,0,1227,1164,4,63,0
4,2,1500,1168,4,332,1
85,2,1157,1156,4,1,1
7,0,1156,1157,3,1,0
44,1,984,1151,4,167,1
61,2,1141,1127,6,14,1
47,1,1150,1223,7,73,1
27,2,1127,1166,4,39,0
36,2,1177,1137,5,40,1
92,1,1155,1125,4,30,0
36,1,1890,1838,4,52,0
42,1,1905,2026,4,121,1
102,1,1678,1714,10,36,1
88,1,1702,1704,3,2,1
112,1,1713,1743,5,30,1
39,2,1703,1711,8,8,0
63,2,1699,1713,6,14,0
35,2,1702,1728,5,26,0
43,1,1642,1685,8,43,1
120,1,1695,1679,4,16,0
71,2,1700,1706,2,6,0
90,1,1716,1722,9,6,1
29,2,1703,1771,8,68,0
87,2,1740,1713,4,27,1
52,1,1721,1702,8,19,0
53,2,1692,1674,8,18,1
83,2,1683,1628,2,55,1
67,1,1639,1674,1,35,1
94,1,1683,1734,3,51,1
137,2,1647,1695,8,48,0
56,1,1582,1687,9,105,1
35,2,1680,1577,3,103,1
84,1,1690,1700,2,10,1
37,2,1744,1699,8,45,1
120,1,1708,1733,7,25,1
77,2,1702,1719,3,17,0
91,2,1709,1722,6,13,0
81,2,1768,1717,8,51,1
114,1,1730,1660,4,70,0
38,1,1746,1719,4,27,0
106,1,1730,1694,4,36,0
58,1,1704,1720,6,16,1
111,2,1720,1720,3,0,0
59,2,1709,1725,7,16,0
46,1,1736,1697,4,39,0
122,0,1696,1738,5,42,0
39,2,1728,1706,5,22,1
77,2,1694,1740,5,46,0
99,2,1730,1704,4,26,1
102,1,1714,1720,5,6,1
112,1,1725,1694,2,31,0
38,1,1735,1760,2,25,1
96,1,2384,2199,4,185,0
63,2,2212,2231,3,19,0
349,2,2194,2240,13,46,0
157,2,2162,2122,7,40,1
23,2,2426,2178,9,248,1
64,1,2196,2420,10,224,1
46,2,2413,2219,10,194,1
67,1,2247,2405,10,158,1
102,1,1559,1676,4,117,1
48,1,1357,1676,4,319,1
43,2,1658,1309,4,349,1
100,1,1658,1573,7,85,0
130,0,1500,1658,4,158,0
65,2,1978,1658,4,320,1
3,2,1658,1240,3,418,1
41,0,1705,1658,5,47,0
36,2,1658,1500,5,158,1
82,1,1500,1658,4,158,1
13,2,1658,1500,4,158,1
52,1,1403,1658,1,255,1
39,2,1658,1403,2,255,1
71,1,1658,1531,9,127,0
106,1,1512,1596,3,84,1
90,1,1715,1660,8,55,0
30,1,1345,1676,4,331,1
111,2,1500,1503,6,3,0
32,1,1503,1500,3,3,0
71,2,1875,1433,2,442,1
40,1,1523,1985,2,462,1
97,2,1774,1863,6,89,0
117,0,1774,1250,3,524,0
62,1,1507,1770,9,263,1
14,2,2621,1770,11,851,1
101,2,1770,1447,4,323,1
69,2,1770,1494,2,276,1
55,2,1770,1832,9,62,0
32,1,1770,1824,4,54,1
3,1,1250,1770,3,520,1
26,1,1076,1770,5,694,1
17,2,1770,1625,9,145,1
47,2,1440,1770,10,330,0
85,2,1500,1770,10,270,0
72,1,1770,1950,3,180,1
27,0,2273,2134,14,139,0
86,0,2452,1500,4,952,0
52,1,1500,2621,5,1121,1
97,0,1500,1500,2,0,0
52,1,1500,2209,2,709,1
63,2,2522,1500,6,1022,1
86,1,1500,2621,2,1121,1
143,2,2621,1500,8,1121,1
76,1,1500,1500,2,0,0
82,1,1907,1500,8,407,0
50,1,2438,1907,8,531,0
28,1,1868,1886,7,18,1
135,2,1876,1648,5,228,1
105,2,1500,1876,5,376,0
33,2,1500,1876,6,376,0
11,2,1865,1562,3,303,1
80,0,1685,1562,2,123,0
51,2,1579,1562,8,17,1
54,1,1637,1562,3,75,0
16,1,1562,1657,6,95,1
17,2,1703,1562,9,141,1
74,1,2231,1562,6,669,0
119,0,1949,1562,7,387,0
11,1,1562,1682,6,120,1
127,0,1562,2207,5,645,0
51,2,2207,1562,7,645,1
42,1,1562,2207,2,645,1
63,2,2207,1562,6,645,1
48,1,1562,2207,1,645,1
28,2,2207,1562,3,645,1
56,1,1562,2207,1,645,1
23,2,2207,1562,3,645,1
48,1,1562,2207,1,645,1
57,2,2207,1562,11,645,1
44,1,1562,1934,12,372,1
33,2,1934,1562,11,372,1
61,2,2210,1562,6,648,1
54,1,1562,2210,2,648,1
15,2,1708,1562,9,146,1
16,2,1562,1708,3,146,0
57,2,1562,1784,1,222,0
105,1,1562,2210,2,648,1
23,2,2210,1562,9,648,1
53,1,1562,2210,2,648,1
25,2,2210,1562,7,648,1
22,1,1539,1562,14,23,1
34,1,1562,2210,3,648,1
36,2,2210,1562,5,648,1
86,1,1562,2210,3,648,1
91,2,2210,1562,5,648,1
88,1,1710,1562,11,148,0
38,1,1562,2314,2,752,1
67,2,2291,1562,5,729,1
52,1,1562,2291,2,729,1
29,2,2291,1562,5,729,1
62,1,1562,2291,3,729,1
142,1,1634,1334,4,300,0
23,2,1522,1486,9,36,1
128,1,1495,1495,2,0,0
130,1,1473,1484,5,11,1
119,2,1484,1500,4,16,0
49,2,1484,1500,1,16,0
129,0,1408,1487,7,79,0
69,2,1469,1498,1,29,0
67,2,1486,1538,3,52,0
35,2,1618,1486,2,132,1
49,2,1500,1486,4,14,1
107,0,1373,1489,6,116,0
14,1,1509,1478,4,31,0
38,1,1468,1489,6,21,1
29,2,1479,1478,6,1,1
128,1,1470,1468,5,2,0
52,1,1478,1468,3,10,0
36,2,1457,1490,3,33,0
63,2,1480,1467,6,13,1
137,2,1479,1497,4,18,0
54,1,1487,1599,8,112,1
32,1,1496,1532,10,36,1
55,2,1500,1504,3,4,0
90,1,1512,1581,8,69,1
53,2,1571,1521,8,50,1
64,1,1506,1511,1,5,1
37,2,1504,1522,4,18,0
45,2,1594,1530,3,64,1
92,1,1540,1558,4,18,1
66,1,1440,1532,4,92,1
22,2,1655,1540,5,115,1
81,2,1528,1574,6,46,0
155,0,1528,1530,4,2,0
51,2,1519,1539,6,20,0
68,1,1550,1556,5,6,1
64,2,1509,1550,4,41,0
48,1,1561,1553,3,8,0
72,1,1571,1574,2,3,1
107,2,1561,1570,3,9,0
65,2,1559,1572,1,13,0
104,2,1560,1578,3,18,0
66,1,1571,1564,5,7,0
127,2,1552,1583,1,31,0
88,1,1595,1536,6,59,0
42,1,1603,1584,3,19,0
51,0,1583,1604,4,21,0
95,2,1594,1594,7,0,0
59,2,1583,1584,4,1,0
51,2,1500,1651,6,151,0
46,1,1749,2119,5,370,1
21,2,2119,1991,7,128,1
58,1,1349,2119,8,770,1
38,1,846,2119,2,1273,1
72,1,2147,2113,6,34,0
68,0,2044,2156,14,112,0
132,1,2192,2103,6,89,0
22,2,2178,1955,4,223,1
56,1,1928,2164,7,236,1
85,2,2203,2040,8,163,1
44,1,1833,2193,9,360,1
80,1,1980,2173,11,193,1
43,2,2147,2008,16,139,1
98,1,2104,2098,15,6,0
43,2,2029,2117,7,88,0
57,0,2120,2010,8,110,0
70,1,1706,1983,5,277,1
49,2,1906,1928,7,22,0
107,2,1833,1719,4,114,1
52,1,1728,1662,5,66,0
39,2,1500,1500,10,0,0
79,0,2438,1658,9,780,0
2,2,2411,1658,2,753,1
49,2,1792,1665,5,127,1
113,2,1731,1675,3,56,1
143,2,1663,1675,5,12,0
100,1,1671,1771,5,100,1
166,1,1755,1671,3,84,0
88,1,1671,1994,5,323,1
54,1,1548,1663,10,115,1
116,1,1353,1663,4,310,1
64,1,1348,1660,4,312,1
65,2,1755,1660,2,95,1
54,1,1660,1755,8,95,1
29,2,1755,1660,2,95,1
51,2,1643,1840,5,197,0
125,2,1630,1705,8,75,0
59,2,1942,1633,7,309,1
72,1,1633,1500,9,133,0
45,2,1614,1911,8,297,0
66,1,1788,1614,11,174,0
101,2,1665,1614,3,51,1
1,2,2621,1614,1,1007,1
63,2,1647,1624,5,23,1
92,0,1649,1624,3,25,0
108,0,1938,1736,17,202,0
28,1,1264,1736,5,472,1
14,1,1737,1725,7,12,0
40,2,1715,1711,8,4,1
4,2,1715,1263,4,452,1
161,0,1263,1715,4,452,0
21,2,1715,1263,6,452,1
37,2,1715,1500,4,215,1
38,1,2020,1846,6,174,0
75,2,2148,2028,17,120,1
108,1,2022,2016,6,6,0
41,2,2014,1536,6,478,1
80,1,2027,1993,4,34,0
65,2,1875,2045,3,170,0
33,2,2041,1740,4,301,1
53,2,1741,2062,4,321,0
84,1,2083,1762,4,321,0
49,2,2082,1517,9,565,1
20,1,1369,2082,5,713,1
62,1,1243,2082,3,839,1
51,2,2080,2093,16,13,0
53,2,2087,1909,4,178,1
33,2,2081,1906,4,175,1
92,1,1906,2075,3,169,1
27,2,2068,1912,6,156,1
31,2,1966,2083,10,117,0
63,0,1948,2087,9,139,0
89,1,2104,1903,2,201,0
70,1,1903,2099,3,196,1
72,2,2016,2113,5,97,0
72,2,2105,1989,9,116,1
64,0,2108,2028,5,80,0
41,2,2014,2122,11,108,0
58,2,2115,1999,5,116,1
70,1,2130,1999,2,131,0
33,2,2000,2146,3,146,0
41,2,2138,2027,5,111,1
33,2,2234,2146,11,88,1
50,1,2059,2137,6,78,1
104,1,1982,2131,1,149,1
51,2,2025,2146,5,121,0
37,1,1988,2139,3,151,1
48,1,1994,2132,11,138,1
118,1,2250,2116,5,134,0
116,1,2135,1784,9,351,0
96,1,1833,2131,4,298,1
53,2,2116,2229,14,113,0
45,1,2002,2108,6,106,1
51,2,2096,2120,9,24,0
25,2,2097,2108,9,11,0
82,1,2121,2086,5,35,0
68,1,1659,2119,4,460,1
37,2,2114,1867,7,247,1
73,2,2113,1578,2,535,1
64,1,1742,2111,11,369,1
79,2,2101,2043,5,58,1
83,2,2097,1826,7,271,1
54,1,2049,2088,11,39,1
2,2,1500,1233,2,267,1
25,1,1233,1664,7,431,1
22,2,1902,1233,3,669,1
73,2,1474,1621,3,147,0
71,2,1613,1506,5,107,1
72,1,2621,1613,8,1008,0
173,2,1449,1629,10,180,0
67,2,1619,1614,7,5,1
57,2,1611,1501,7,110,1
154,1,1510,1603,11,93,1
99,2,1881,1607,10,274,1
87,0,1602,1607,3,5,0
24,0,1500,1610,11,110,0
103,2,1606,1557,4,49,1
38,0,1553,1607,4,54,0
92,1,1620,1564,4,56,0
85,2,2621,1600,20,1021,1
64,1,1610,1635,12,25,1
149,2,1644,1621,1,23,1
106,1,1634,1573,5,61,0
77,0,1635,1599,5,36,0
48,1,1695,1645,3,50,0
23,1,1553,1687,8,134,1
89,2,1694,1536,5,158,1
51,2,1699,1706,4,7,0
76,1,1715,1796,5,81,1
56,1,1611,1706,3,95,1
60,1,1718,1727,4,9,1
62,1,1713,1706,5,7,0
43,2,1559,1462,4,97,1
37,2,1355,2052,3,697,0
49,2,1251,1500,7,249,0
54,1,1500,1251,8,249,0
39,2,1401,1354,5,47,1
114,1,1500,1566,9,66,1
173,2,1827,1941,4,114,0
76,0,1944,1823,5,121,0
118,1,1828,1937,5,109,1
126,0,1917,1828,11,89,0
20,1,1840,1805,5,35,0
53,2,1872,1849,2,23,1
63,2,1836,1942,2,106,0
28,2,1934,1844,4,90,1
59,1,1855,1823,2,32,0
49,2,1843,1893,3,50,0
57,2,1832,1808,1,24,1
50,1,1896,1819,3,77,0
55,2,1817,1838,5,21,0
106,1,1825,1914,2,89,1
104,1,1904,1812,6,92,0
93,2,1838,1822,8,16,1
62,1,1892,1809,7,83,0
10,1,1817,1920,5,103,1
95,2,1985,1823,2,162,1
137,2,1902,1831,7,71,1
24,1,1840,1893,5,53,1
117,2,1830,1803,1,27,1
85,2,1820,1808,3,12,1
86,1,1819,1810,5,9,0
60,1,1821,1799,2,22,0
137,2,1787,1809,1,22,0
105,2,1781,1798,5,17,0
60,1,1810,1762,5,48,0
108,0,1763,1811,7,48,0
118,1,1748,2084,5,336,1
61,2,1748,1818,5,70,0
129,0,1748,1818,5,70,0
135,2,1732,1748,1,16,0
151,2,1712,1797,5,85,0
170,1,1746,1674,4,72,0
46,1,1705,1737,7,32,1
164,0,1817,1693,2,124,0
93,2,1652,1648,6,4,1
8,1,1561,1556,6,5,0
35,1,1594,1734,8,140,1
117,0,1562,1736,3,174,0
13,2,1729,1620,1,109,1
28,1,1699,1788,5,89,1
29,2,1777,1887,7,110,0
179,2,1500,1801,3,301,0
52,1,2169,2166,2,3,0
82,1,2166,2153,4,13,0
85,2,2150,1784,3,366,1
64,1,2156,2137,4,19,0
35,2,2125,2072,4,53,1
54,1,2211,2109,7,102,0
49,2,2106,1725,2,381,1
129,2,2113,2120,2,7,0
29,2,2100,2276,12,176,0
67,2,2095,1831,9,264,1
64,1,1982,2085,9,103,1
120,1,1868,2079,16,211,1
43,2,2077,1509,6,568,1
30,1,1573,2076,6,503,1
136,1,1458,1407,12,51,0
73,0,1357,1500,6,143,0
40,1,1500,1576,4,76,1
44,1,1918,1888,5,30,0
117,2,1874,1951,13,77,0
38,1,1990,1859,8,131,0
51,2,1841,2036,13,195,0
81,2,2465,2041,10,424,1
64,1,2079,2032,8,47,0
139,2,1990,2119,5,129,0
83,2,2125,2115,3,10,1
46,1,2163,2198,7,35,1
74,1,2240,2074,12,166,0
90,1,2111,2299,14,188,1
62,2,2082,1796,6,286,1
32,1,2049,1960,5,89,0
70,1,1738,1500,9,238,0
68,1,1500,1500,7,0,0
94,1,1500,1500,3,0,0
103,0,1500,1500,12,0,0
17,2,1564,1500,5,64,1
39,1,1569,1772,6,203,1
138,1,1539,1559,5,20,1
65,2,1693,1661,4,32,1
69,2,1679,1785,4,106,0
116,1,1799,1665,3,134,0
75,2,1636,1677,3,41,0
57,1,1686,1723,2,37,1
49,2,1713,1696,2,17,1
78,1,1707,1702,9,5,0
12,2,1288,1674,2,386,0
38,1,1674,1748,2,74,1
67,2,2340,1874,4,466,1
55,2,1874,2103,9,229,0
70,1,1901,1861,4,40,0
43,2,2065,1861,4,204,1
59,2,1852,1781,2,71,1
47,2,1852,1758,3,94,1
10,1,1758,1852,3,94,1
103,2,1572,1680,3,108,0
53,2,1672,1574,4,98,1
63,2,1661,1630,4,31,1
38,1,1500,1654,4,154,1
28,1,1160,1166,5,6,1
35,1,1174,1385,4,211,1
115,2,1154,1195,5,41,0
51,2,2344,2150,8,194,1
49,0,2150,2501,7,351,0
64,1,2401,2150,17,251,0
57,0,2150,2406,7,256,0
38,0,1500,2150,10,650,0
69,2,2447,2150,6,297,1
40,1,2621,2150,7,471,0
137,0,1500,2150,8,650,0
82,1,2216,2150,17,66,0
40,1,2216,2150,2,66,0
58,1,2621,2150,3,471,0
59,2,2406,2150,13,256,1
69,0,2398,2139,9,259,0
48,1,1384,2139,9,755,1
69,2,2139,1384,7,755,1
42,1,2621,2139,16,482,0
27,1,2046,1929,10,117,0
115,2,1594,1525,4,69,1
42,1,1475,1586,7,111,1
73,2,1577,1484,5,93,1
1,2,2403,1746,1,657,1
5,2,2454,1746,3,708,1
2,1,1586,1333,2,253,0
53,2,1639,1596,4,43,1
57,1,1598,1940,3,342,1
39,2,2061,1598,5,463,1
50,1,1612,1529,6,83,0
55,2,1698,1621,10,77,1
35,2,1619,1188,4,431,1
104,1,1599,1608,4,9,1
83,2,1608,2621,3,1013,0
131,0,2145,2251,2,106,0
120,1,2039,2102,5,63,1
47,2,2092,2048,10,44,1
48,1,2109,1966,11,143,0
52,1,1866,2104,9,238,1
83,1,2117,2087,4,30,0
107,2,2113,1838,5,275,1
39,2,2104,1980,15,124,1
64,1,1988,2095,8,107,1
42,1,1872,2089,8,217,1
145,2,2083,1876,4,207,1
48,1,1775,2079,6,304,1
43,2,2077,1694,4,383,1
62,1,1628,2075,9,447,1
32,2,2244,2082,3,162,1
83,2,2080,1639,6,441,1
70,1,2100,1827,9,273,0
58,1,1702,2098,8,396,1
52,1,2111,2084,8,27,0
182,1,1746,2108,9,362,1
56,1,1527,2108,1,581,1
48,1,2126,1906,5,220,0
54,1,1917,2121,5,204,1
66,1,1687,2119,10,432,1
64,1,1170,1662,2,492,1
51,2,1261,1237,1,24,1
71,2,1100,1306,3,206,0
49,2,1590,1100,7,490,1
34,1,1100,1590,3,490,1
88,1,1302,875,3,427,0
11,0,1234,1335,4,101,0
11,2,1522,1500,6,22,1
7,0,1542,1535,1,7,0
122,1,1340,1542,6,202,1
19,0,1334,1550,6,216,0
123,2,1314,1571,6,257,0
25,2,1566,1319,8,247,1
22,1,1324,1560,6,236,1
79,2,1554,1329,2,225,1
105,2,1548,1335,4,213,1
22,1,1341,1542,6,201,1
84,2,1258,1561,3,303,0
44,1,1347,1554,1,207,1
15,2,1554,849,3,705,1
23,2,1552,1075,4,477,1
50,1,1196,1549,2,353,1
81,2,1545,1199,4,346,1
46,1,1202,1542,3,340,1
71,2,1540,1091,2,449,1
64,1,1351,1533,4,182,1
68,1,2166,2318,7,152,1
93,2,2308,2173,7,135,1
74,1,2180,2298,7,118,1
90,1,2403,2014,13,389,0
63,2,1968,1626,6,342,1
65,1,1637,1640,6,3,1
17,2,1630,1649,4,19,0
37,2,1643,1466,11,177,1
55,2,1590,1656,10,66,0
73,1,1671,1560,2,111,0
35,2,1658,1683,6,25,0
145,2,1670,1716,9,46,0
56,1,1145,1669,5,524,1
39,2,1655,1733,9,78,0
146,1,1659,1979,2,320,1
99,2,1650,1563,4,87,1
57,1,1579,1641,10,62,1
110,1,1649,1761,3,112,1
51,1,1791,1633,10,158,0
94,1,1569,1624,1,55,1
45,2,1613,1593,6,20,1
33,1,1523,1605,3,82,1
54,1,1792,1588,7,204,0
66,1,1600,1584,17,16,0
93,2,1589,1563,6,26,1
79,1,1593,1885,11,292,1
78,1,1587,1582,1,5,0
44,1,1592,1628,3,36,1
77,2,1185,1179,3,6,1
117,0,1153,1185,4,32,0
44,1,1196,1264,3,68,1
39,2,1186,1098,3,88,1
53,2,1459,1191,4,268,1
73,1,1146,1158,6,12,1
61,2,1332,1167,7,165,1
49,2,1160,946,3,214,1
10,1,1024,1160,3,136,1
38,1,1160,1217,5,57,1
24,1,1166,1422,7,256,1
45,2,1473,1170,2,303,1
50,2,1191,1146,1,45,1
47,1,1146,984,2,162,0
16,1,1081,1133,2,52,1
46,1,1151,1118,4,33,0
71,2,1133,1161,4,28,0
63,2,952,1159,2,207,0
49,2,1194,1175,3,19,1
7,2,1227,1192,3,35,1
49,2,1217,1210,3,7,1
134,1,1228,1262,8,34,1
18,1,1244,1263,4,19,1
99,2,1229,1133,8,96,1
131,2,1334,1246,6,88,1
60,1,1269,1269,4,0,0
104,1,1393,1234,4,159,0
44,1,1214,1594,7,380,1
58,1,1214,2621,10,1407,1
41,2,1793,1216,5,577,1
154,1,1224,1530,3,306,1
56,1,1226,1848,6,622,1
49,2,2191,1174,6,1017,1
57,2,1139,1221,5,82,0
111,2,1503,1146,3,357,1
46,1,1156,1111,7,45,0
70,1,1136,1227,4,91,1
75,2,1212,1169,5,43,1
41,2,1353,1192,3,161,1
32,1,1237,1237,6,0,0
86,1,1285,1309,4,24,1
27,2,1220,1252,5,32,0
51,2,1313,1285,5,28,1
28,1,1197,1197,5,0,0
89,2,1323,1310,6,13,1
33,1,1500,1471,6,29,0
50,2,1913,1147,1,766,1
24,1,1147,1913,8,766,1
86,1,1670,2621,10,951,1
74,1,1670,2621,10,951,1
72,1,1730,1656,1,74,0
92,1,1662,1844,5,182,1
48,1,1440,1647,3,207,1
73,1,1655,1762,2,107,1
66,2,1636,1939,6,303,0
122,0,1366,1644,5,278,0
124,1,1656,1612,7,44,0
70,1,1549,1648,2,99,1
39,2,1641,1488,6,153,1
39,2,1428,1659,8,231,0
110,1,1632,1648,4,16,1
52,2,1643,1457,6,186,1
87,2,1582,1656,3,74,0
50,2,1651,1437,6,214,1
63,2,1646,1436,6,210,1
121,2,1632,1692,2,60,0
36,2,1653,1624,5,29,1
82,1,1638,1552,6,86,0
128,1,1610,1627,8,17,1
57,2,1616,1586,5,30,1
61,2,1607,1542,6,65,1
75,2,1616,1618,5,2,0
64,1,1491,1624,3,133,1
60,1,1573,1614,7,41,1
93,2,1462,1631,4,169,0
44,0,1638,1413,5,225,0
92,1,1178,1636,12,458,1
92,1,1649,1597,4,52,0
95,2,1639,1588,5,51,1
56,2,1630,1560,11,70,1
32,1,1477,1622,7,145,1
89,2,1601,1998,6,397,0
77,2,2135,1602,1,533,1
31,2,1584,1786,9,202,0
59,2,1844,1589,5,255,1
138,0,1579,1986,6,407,0
26,1,1446,1572,5,126,1
92,1,1881,1935,4,54,1
60,1,2011,1865,3,146,0
60,1,1875,1921,5,46,1
70,1,1924,1861,3,63,0
75,0,2310,1861,4,449,0
24,1,1875,1809,5,66,0
62,1,1342,1874,1,532,1
39,2,1495,1896,4,401,0
52,1,1905,2022,4,117,1
125,1,1804,1895,4,91,1
34,1,1899,2207,5,308,1
32,2,2005,1908,2,97,1
48,1,1688,1899,7,211,1
61,2,1899,2061,2,162,0
106,1,2137,1899,5,238,0
54,1,2449,1899,1,550,0
68,1,1932,1886,3,46,0
137,2,1908,1898,8,10,1
59,2,1897,1303,4,594,1
85,0,1524,1906,1,382,0
103,2,2387,1906,4,481,1
32,2,2387,1906,2,481,1
113,2,1898,1790,4,108,1
46,1,1907,1983,3,76,1
52,1,1516,1905,2,389,1
146,1,1977,1816,2,161,0
104,1,1716,1972,14,256,1
97,2,1963,1857,2,106,1
55,2,1953,1894,2,59,1
84,1,1753,1947,4,194,1
60,1,1912,1936,2,24,1
57,2,1925,1880,2,45,1
72,1,1629,1921,8,292,1
69,2,1917,1621,2,296,1
147,2,1904,1902,8,2,1
86,1,1573,1901,3,328,1
149,2,1894,1717,3,177,1
37,0,1911,1894,1,17,0
41,1,1286,1893,6,607,1
60,1,1898,2125,3,227,1
138,1,1904,2122,2,218,1
111,2,1929,1916,4,13,1
107,2,1903,1914,2,11,0
28,1,1919,1889,14,30,0
64,1,1403,1887,2,484,1
139,0,1736,1893,2,157,0
82,1,1906,1890,1,16,0
78,1,1434,1912,2,478,1
71,0,1919,1682,1,237,0
23,2,1594,1942,3,348,0
45,2,1979,1954,4,25,1
117,2,1947,1771,2,176,1
111,2,2195,1952,2,243,1
149,2,1937,1975,2,38,0
94,1,1949,1986,1,37,1
47,2,1948,1397,5,551,1
115,2,1690,1970,4,280,0
97,2,1969,1320,2,649,1
31,2,1500,1500,5,0,0
16,1,1430,1311,5,119,0
44,1,1443,1381,5,62,0
54,1,1454,1421,6,33,0
43,2,1444,1465,1,21,0
34,1,1387,1457,9,70,1
122,1,1417,1447,3,30,1
51,2,1436,1439,12,3,0
62,1,1455,1081,10,374,0
30,1,1318,1448,10,130,1
79,2,1437,1446,9,9,0
32,1,1448,1436,4,12,0
78,1,1308,1441,5,133,1
99,2,1500,2621,3,1121,0
23,2,2350,1500,4,850,1
28,1,2217,1500,7,717,0
42,2,1719,1679,6,40,1
42,1,1689,1670,8,19,0
59,2,1672,1701,3,29,0
80,1,1695,1923,11,228,1
31,1,1706,1698,4,8,0
107,2,1687,1717,7,30,0
18,1,1728,1723,8,5,0
72,1,1648,1719,4,71,1
45,2,1719,1765,7,46,0
66,1,1648,1710,4,62,1
93,2,1696,1722,3,26,0
90,1,1732,1768,13,36,1
23,2,1833,1740,6,93,1
118,1,1433,1737,3,304,1
103,0,1729,2008,7,279,0
23,2,1722,1605,8,117,1
91,2,1713,1659,6,54,1
56,1,1605,1698,1,93,1
71,2,1690,1613,3,77,1
48,1,1622,1681,1,59,1
80,1,1702,1681,6,21,0
33,2,1568,1696,8,128,0
84,1,1707,1699,3,8,0
51,2,1453,1724,6,271,0
47,1,1735,1733,5,2,0
74,1,1744,1801,9,57,1
77,1,1854,1730,7,124,0
54,1,1705,1719,6,14,1
75,2,1709,1716,5,7,0
89,2,1694,1825,5,131,0
62,1,1651,1684,3,33,1
49,2,1706,1695,2,11,1
67,2,1683,1717,5,34,0
73,2,1707,1693,2,14,1
43,2,1758,1702,4,56,1
70,1,1713,1709,11,4,0
28,1,1724,1734,7,10,1
16,1,1730,1882,4,152,1
53,2,1601,1510,3,91,1
21,2,1615,1518,3,97,1
40,2,1504,1623,4,119,0
54,1,1516,1454,2,62,0
36,1,1509,1505,1,4,0
60,1,1325,1499,2,174,1
35,2,1494,1313,3,181,1
54,1,1506,1452,4,54,0
34,1,1554,1494,2,60,0
64,2,1488,1309,8,179,1
37,1,1501,1421,9,80,0
51,2,1473,1513,3,40,0
3,2,1314,1513,3,199,0
135,0,1655,1509,3,146,0
99,2,1492,1691,8,199,0
65,2,1447,1505,4,58,0
43,2,1495,1474,6,21,1
80,1,1503,1570,2,67,1
51,2,1497,1351,7,146,1
100,1,1555,1484,2,71,0
44,1,1489,1473,1,16,0
77,0,1469,1604,6,135,0
66,1,1370,1461,2,91,1
120,1,1502,1448,1,54,0
94,2,1435,1515,3,80,0
51,2,1506,1444,1,62,1
127,2,1431,1520,4,89,0
96,2,1511,1439,2,72,1
78,1,1512,2085,11,573,1
88,1,1507,2084,11,577,1
113,2,2082,1509,10,573,1
21,2,2069,2030,12,39,1
20,1,2043,2104,4,61,1
60,1,2063,2010,5,53,0
57,2,1970,2087,2,117,0
57,2,2077,1899,7,178,1
52,1,1780,2015,3,235,1
152,1,1793,2015,8,222,1
18,1,2015,1793,10,222,0
120,1,1793,2015,4,222,1
105,2,2015,1793,2,222,1
39,0,2524,1500,8,1024,0
18,1,1527,1882,3,355,1
4,1,1527,1882,1,355,1
54,1,1500,1901,5,401,1
4,1,1533,1897,1,364,1
5,2,1894,1539,1,355,1
26,1,1545,1890,3,345,1
4,1,1552,1887,1,335,1
115,0,1923,1887,3,36,0
26,1,1634,1821,6,187,1
66,1,1773,1821,4,48,1
108,1,1821,1842,11,21,1
154,1,1512,1821,6,309,1
21,2,1821,1832,5,11,0
48,1,1832,1821,7,11,0
89,0,1821,1832,5,11,0
31,2,1832,1821,7,11,1
66,1,1500,1821,5,321,1
80,2,1821,1820,5,1,1
62,2,1500,1821,11,321,0
120,1,1877,1821,11,56,0
38,2,1902,1830,8,72,1
61,2,1830,1311,8,519,1
28,1,1824,1830,3,6,1
99,2,1548,1842,5,294,0
49,1,1858,1730,3,128,0
44,1,1891,1845,6,46,0
55,2,1876,1856,4,20,1
92,1,1867,1883,8,16,1
27,2,1864,1449,4,415,1
98,1,1922,1851,5,71,0
24,1,1861,1899,4,38,1
4,1,1527,1861,1,334,1
16,1,1878,1698,6,180,0
85,2,1878,1906,14,28,0
70,1,1660,1873,4,213,1
36,1,1707,1873,4,166,1
124,0,1806,1875,11,69,0
61,2,1864,1842,5,22,1
66,1,1853,1853,6,0,0
20,1,1882,1840,6,42,0
49,2,1832,1696,4,136,1
42,1,1704,1824,2,120,1
47,2,1427,1444,8,17,0
25,1,1354,1406,9,52,1
61,2,1437,1431,4,6,1
49,2,1411,1372,4,39,1
57,2,1428,1441,5,13,0
58,1,1383,1412,3,29,1
30,1,1528,1500,3,28,0
12,1,1543,1426,2,117,0
34,1,1434,1535,6,101,1
81,2,1526,1442,4,84,1
107,2,1505,1898,3,393,0
17,2,1895,1507,6,388,1
78,1,1451,1497,2,46,1
42,1,1460,1487,2,27,1
6,0,1459,1488,2,29,0
61,2,1447,1501,1,54,0
50,1,1457,1491,6,34,1
88,1,1467,1479,2,12,1
9,2,1785,1483,1,302,1
26,1,1487,1781,2,294,1
47,1,1491,1749,2,258,1
5,2,1482,1403,3,79,1
37,0,1218,1490,2,272,0
109,2,1528,1500,2,28,1
59,1,1505,1732,2,227,1
46,1,1500,1505,6,5,1
50,1,1436,1495,3,59,1
40,1,1499,1800,2,301,1
53,2,1855,1502,6,353,1
15,2,1502,1530,3,28,0
52,2,1502,1473,6,29,1
32,1,1502,1467,2,35,0
99,2,1803,1502,2,301,1
19,2,1697,1502,8,195,1
89,2,1493,1416,2,77,1
71,2,1130,1048,8,82,1
43,2,994,1091,3,97,0
48,1,1186,1091,3,95,0
171,2,1071,891,4,180,1
34,1,1071,938,5,133,0
63,2,987,1125,6,138,0
79,2,1928,1529,5,399,1
48,1,1684,1734,3,50,1
76,1,1609,1726,3,117,1
54,1,1730,2003,6,273,1
131,2,1762,1742,11,20,1
48,1,1743,2269,4,526,1
89,2,2268,1744,5,524,1
88,1,1761,1578,5,183,0
92,1,1820,1820,6,0,0
58,1,1332,1820,11,488,1
52,1,1820,2621,6,801,1
65,2,2392,1820,11,572,1
73,2,1560,1403,4,157,1
57,2,1544,1771,8,227,0
13,2,1798,1549,7,249,1
29,1,1555,1728,6,173,1
38,1,1568,1515,6,53,0
44,2,1416,1585,2,169,0
33,2,1796,1591,4,205,1
24,1,1607,1455,4,152,0
16,1,1748,1591,4,157,0
53,2,1588,1230,4,358,1
89,2,1576,1573,4,3,1
22,2,1570,1392,6,178,1
67,2,1570,1582,3,12,0
113,2,1565,1730,2,165,0
76,2,1470,1581,3,111,0
55,2,1571,1505,7,66,1
55,2,1950,2212,1,262,0
49,2,1950,1226,2,724,1
78,1,1950,1885,4,65,0
29,0,1950,2204,2,254,0
65,0,1950,1500,2,450,0
66,0,1950,1819,4,131,0
112,0,1950,1477,2,473,0
70,0,1950,1500,3,450,0
50,1,2036,1706,6,330,0
40,1,1795,2036,6,241,1
33,2,2023,1671,2,352,1
30,1,1675,2008,8,333,1
53,2,1990,1678,2,312,1
30,0,1990,1465,5,525,0
11,0,1990,1756,2,234,0
3,0,1990,1779,2,211,0
67,0,1990,1447,2,543,0
41,1,1458,1980,4,522,1
28,2,1967,1500,2,467,1
52,2,1967,1295,3,672,1
30,1,2102,1967,6,135,0
56,1,1657,2033,4,376,1
56,1,1541,2033,11,492,1
41,2,2033,1500,3,533,1
75,2,2033,1567,2,466,1
59,2,2033,1500,3,533,1
27,1,1502,2033,2,531,1
15,2,1516,1500,2,16,1
84,1,1637,1500,3,137,0
29,1,1500,1336,2,164,0
19,2,1544,1500,5,44,1
79,2,2447,1802,7,645,1
117,2,2522,1802,6,720,1
91,2,2452,1802,14,650,1
36,0,1802,2524,7,722,0
109,2,1500,1802,13,302,0
101,2,1500,1802,2,302,0
56,1,1802,2468,8,666,1
67,2,2485,1802,12,683,1
66,0,2247,1802,1,445,0
64,0,2426,1802,3,624,0
81,0,2400,1802,3,598,0
32,0,2404,1802,2,602,0
49,2,2621,1802,16,819,1
10,2,2035,1802,7,233,1
77,2,2621,1802,16,819,1
34,1,1802,2500,7,698,1
39,1,1802,1500,7,302,0
29,2,2236,1802,6,434,1
88,1,1802,1500,10,302,0
53,0,1802,2305,8,503,0
88,0,2400,1802,10,598,0
36,2,2400,1802,8,598,1
74,1,1802,2417,6,615,1
94,1,1802,2500,7,698,1
37,2,2422,1802,8,620,1
37,1,1802,1500,11,302,0
91,2,1500,1802,6,302,0
69,0,1802,1500,7,302,0
59,2,1500,1802,7,302,0
58,2,1500,1802,10,302,0
95,2,2500,1802,4,698,1
37,1,1802,2473,20,671,1
73,2,2169,2147,7,22,1
43,2,2153,2168,9,15,0
56,1,2180,2134,4,46,0
119,0,2132,2191,12,59,0
27,2,2118,2151,12,33,0
97,1,2167,2203,13,36,1
97,2,2142,2266,5,124,0
76,1,2116,2124,8,8,1
30,1,2130,2103,10,27,0
32,0,2107,2043,10,64,0
48,1,1935,2094,8,159,1
35,2,2069,2130,10,61,0
25,2,2047,2035,8,12,1
53,1,1694,2041,9,347,1
58,1,2120,2008,9,112,0
62,1,2030,2091,6,61,1
76,1,2162,1989,4,173,0
16,2,1985,1540,4,445,1
127,2,2169,2002,9,167,1
30,1,2020,1952,2,68,0
73,2,1918,1883,7,35,1
88,2,1868,1949,7,81,0
52,1,1826,1769,10,57,0
62,1,2034,1645,2,389,0
13,1,1661,2030,8,369,1
52,1,1982,1512,5,470,0
70,1,1530,1403,3,127,0
52,1,1836,1905,8,69,1
99,2,1896,1842,3,54,1
39,2,1886,1885,3,1,1
31,2,1737,1901,6,164,0
130,1,1910,1955,3,45,1
31,2,1843,1924,3,81,0
62,1,1683,1919,2,236,1
30,1,1930,1912,3,18,0
98,1,1912,1920,9,8,1
116,1,1975,1907,9,68,0
36,1,1918,1914,2,4,0
47,2,1818,1932,3,114,0
116,1,1944,1906,2,38,0
61,2,1976,1954,9,22,1
32,1,1963,2020,5,57,1
87,2,1956,1836,3,120,1
109,2,1953,1584,2,369,1
24,1,1698,1949,3,251,1
87,2,1917,1961,4,44,0
101,2,1953,1886,2,67,1
103,2,1941,1977,3,36,0
53,2,1931,1922,2,9,1
88,1,1847,1923,9,76,1
39,2,1884,1935,3,51,0
31,2,2079,1941,7,138,1
121,2,1915,1943,3,28,0
147,2,1914,1996,1,82,0
38,1,1914,1903,9,11,0
30,1,2014,1882,4,132,0
100,0,1995,2014,6,19,0
170,1,2060,1779,5,281,0
81,2,2044,1984,8,60,1
101,2,1897,2109,10,212,0
116,1,2145,1977,10,168,0
30,1,1898,2134,2,236,1
130,1,2176,1917,1,259,0
105,2,2156,2055,5,101,1
70,1,1888,2145,2,257,1
27,2,2129,1945,4,184,1
44,1,1763,2122,2,359,1
170,0,2149,1757,5,392,0
28,1,2255,2100,8,155,0
57,2,2181,2132,3,49,1
89,2,1980,1860,11,120,1
133,2,1762,2220,5,458,0
39,2,2213,1860,3,353,1
33,2,2182,2208,11,26,0
38,1,1808,2175,8,367,1
49,2,2171,1668,11,503,1
38,1,1085,2171,4,1086,1
123,2,2087,2162,6,75,0
49,2,2156,1700,9,456,1
138,1,2033,2121,4,88,1
94,0,2114,2162,11,48,0
46,1,2203,2028,3,175,0
43,2,1935,2064,11,129,0
134,1,1971,2195,9,224,1
102,1,2054,1815,2,239,0
56,1,1652,1716,4,64,1
127,2,1500,1575,6,75,0
130,0,1776,1728,11,48,0
68,1,1728,1776,4,48,1
88,1,2036,1776,6,260,0
54,1,1776,2036,2,260,1
128,1,1776,1718,2,58,0
116,1,1718,1776,7,58,1
54,1,1718,1776,3,58,1
19,2,1776,1718,4,58,1
82,1,1697,1776,5,79,1
45,2,1348,1397,5,49,0
74,1,1262,1397,9,135,1
9,2,1337,1411,1,74,0
43,2,1348,1425,8,77,0
7,2,1342,1440,5,98,0
36,1,1799,1822,4,23,1
47,1,1471,1513,3,42,1
40,1,1523,1523,5,0,0
53,2,1523,1387,2,136,1
55,1,1533,1572,4,39,1
84,1,1508,1523,3,15,1
64,2,1786,1527,4,259,1
38,1,1537,1537,4,0,0
61,2,1527,1513,4,14,1
28,1,1534,1654,4,120,1
22,1,1545,1532,4,13,0
43,2,1604,1554,7,50,1
57,2,1562,1564,3,2,0
92,1,1506,1558,3,52,1
67,2,1547,1563,3,16,0
21,2,1535,1580,4,45,0
31,2,1525,1515,4,10,1
124,1,1532,1650,6,118,1
49,2,1538,1543,3,5,0
40,2,1509,1554,9,45,0
49,2,1546,1478,6,68,1
78,1,1542,1535,9,7,0
58,1,1499,1526,3,27,1
69,0,1527,1477,4,50,0
155,2,1517,1496,6,21,1
47,2,1507,1505,4,2,1
15,2,1519,1517,5,2,1
95,2,1503,1528,3,25,0
34,1,1539,1537,6,2,0
52,1,1549,1556,8,7,1
52,1,1520,1539,6,19,1
47,2,1529,1551,6,22,0
30,1,1564,1478,6,86,0
37,2,1507,1576,3,69,0
105,2,1567,1522,4,45,1
41,2,1568,1563,3,5,1
60,1,1578,1607,4,29,1
52,1,1563,1567,6,4,1
69,2,1559,1488,2,71,1
45,2,1500,1458,4,42,1
117,2,1362,1471,6,109,0
55,2,1462,1403,6,59,1
47,2,2621,1715,16,906,1
30,1,2621,1715,9,906,0
83,2,1715,1721,4,6,0
47,2,2621,1715,7,906,1
17,1,1715,2621,6,906,1
104,1,1715,2621,6,906,1
41,2,1826,1648,2,178,1
116,1,1603,1570,6,33,0
41,2,1590,1641,5,51,0
43,2,1670,1599,5,71,1
52,1,1612,1560,6,52,0
56,1,1569,1602,4,33,1
134,1,1580,1580,3,0,0
59,2,1558,1546,7,12,1
74,1,1647,1543,9,104,0
81,2,1531,1541,2,10,0
168,1,1542,1578,5,36,1
29,1,1500,1883,3,383,1
132,1,1890,2139,4,249,1
55,2,2131,2018,10,113,1
95,2,2116,2252,8,136,0
101,2,1891,1702,3,189,1
47,2,1697,1496,4,201,1
71,2,1686,1657,5,29,1
52,1,1542,1679,10,137,1
18,1,1286,1677,10,391,1
47,2,1672,1437,8,235,1
39,2,1664,1590,4,74,1
93,2,1592,1677,9,85,0
69,2,1658,1689,6,31,0
20,1,1702,1607,4,95,0
45,2,1734,1713,4,21,1
50,1,1693,1702,3,9,1
53,2,1883,1708,2,175,1
56,1,1719,1710,6,9,0
84,1,1950,1960,3,10,1
29,2,1864,1976,10,112,0
72,2,2065,1976,6,89,1
63,2,1976,1988,10,12,0
141,2,1976,1987,4,11,0
92,1,2035,1961,6,74,0
64,1,1975,1908,8,67,0
90,1,1463,1974,3,511,1
70,1,1997,1480,7,517,0
68,1,1950,1997,2,47,1
63,2,2229,2002,10,227,1
52,1,1468,1509,3,41,1
75,2,1904,1509,4,395,1
50,1,1509,1904,8,395,1
105,2,1502,1361,4,141,1
69,2,1913,1504,7,409,1
116,1,1509,1738,4,229,1
41,1,1369,1502,6,133,1
44,1,1454,1493,7,39,1
109,2,1427,1493,9,66,0
17,2,1493,1781,5,288,0
47,2,1427,1493,9,66,0
20,1,1493,1781,4,288,1
15,2,1493,1427,11,66,1
45,2,1781,1493,6,288,1
45,2,1781,1493,4,288,1
46,1,1498,1482,11,16,0
77,2,1461,1493,6,32,0
43,2,1638,1500,10,138,1
81,2,1488,1527,5,39,0
139,2,1501,1498,6,3,1
54,1,1547,1486,7,61,0
60,1,1492,1658,4,166,1
36,1,1500,1605,3,105,1
1,2,2621,1384,1,1237,1
22,1,1384,2621,1,1237,1
90,1,1216,1555,3,339,1
44,1,1426,1946,5,520,1
55,2,1946,1259,2,687,1
56,1,1765,1939,9,174,1
33,2,1938,1352,3,586,1
31,2,1985,1949,5,36,1
34,1,1927,1938,5,11,1
109,2,1924,1998,13,74,0
96,1,1717,1918,1,201,1
67,2,1910,1773,6,137,1
91,2,1902,1789,6,113,1
138,0,1663,1909,5,246,0
88,1,1924,1850,14,74,0
38,1,1350,1923,8,573,1
98,1,1811,1914,6,103,1
58,1,2128,1896,5,232,0
50,1,1901,2123,3,222,1
43,2,1776,1917,4,141,0
52,1,1930,1867,8,63,0
108,1,2106,1993,8,113,0
43,2,1993,1500,5,493,1
96,1,1500,1993,8,493,1
87,2,1987,1828,12,159,1
56,1,1835,1980,2,145,1
112,1,1688,1711,2,23,1
152,1,1646,1679,4,33,1
33,2,1716,1696,3,20,1
50,1,1709,1628,4,81,0
58,1,1636,1701,10,65,1
45,2,1692,1645,5,47,1
120,1,1550,1685,10,135,1
37,2,1675,1654,4,21,1
90,1,1651,1674,7,23,1
69,2,1641,1632,5,9,1
120,1,1621,1630,2,9,1
109,2,1566,1597,10,31,0
53,2,1551,1592,4,41,0
81,2,1569,1564,4,5,1
85,0,1558,1691,4,133,0
61,2,1731,1566,7,165,1
51,2,1813,1571,5,242,1
43,2,1559,1525,3,34,1
51,2,1697,1558,11,139,1
51,2,1777,1565,6,212,1
69,2,1553,1482,4,71,1
53,2,1648,1565,8,83,1
17,2,1529,1583,11,54,0
39,2,1572,1451,9,121,1
78,1,1580,1799,4,219,1
62,1,1534,1553,6,19,1
49,2,1616,1568,8,48,1
27,1,1511,1553,11,42,1
36,1,1573,1541,6,32,0
3,2,1500,1342,3,158,1
2,1,1500,1537,2,37,1
44,1,1853,1826,6,27,0
35,2,1826,1853,5,27,0
53,2,1921,1647,5,274,1
131,2,1396,1670,4,274,0
50,1,1691,1499,3,192,0
24,1,1708,1649,7,59,0
36,1,1559,1699,3,140,1
15,2,1786,1775,7,11,1
49,2,1774,1786,11,12,0
37,2,1500,1416,10,84,1
7,1,1431,1416,6,15,0
42,1,1416,2361,5,945,1
83,2,2401,1416,9,985,1
59,2,2401,1416,9,985,1
29,2,2361,1695,6,666,1
18,1,2066,1695,6,371,0
138,1,1720,1683,6,37,0
57,2,1674,1579,9,95,1
38,1,1587,1666,6,79,1
42,2,1751,1675,3,76,1
22,1,1684,1742,4,58,1
23,2,1732,1694,2,38,1
36,1,1762,1681,6,81,0
92,1,1690,1758,5,68,1
17,2,1749,1700,2,49,1
17,2,1689,1677,6,12,1
67,2,1689,1567,2,122,1
52,1,1698,1785,4,87,1
36,2,1664,1711,3,47,0
45,2,1510,1729,3,219,0
66,1,1500,1500,2,0,0
45,2,1781,1750,6,31,1
75,2,1426,969,3,457,1
93,2,1455,971,2,484,1
50,1,972,1662,2,690,1
81,2,1927,2434,7,507,0
64,1,2619,1927,12,692,0
51,2,1814,1805,4,9,1
24,1,1500,1500,5,0,0
51,2,1500,1500,5,0,0
76,1,1961,1500,5,461,0
45,2,1500,1961,4,461,0
101,2,1621,1247,5,374,1
63,2,1500,1621,7,121,0
52,1,1621,1500,13,121,0
80,1,1500,1621,9,121,1
11,2,1621,1500,3,121,1
59,1,1621,1813,5,192,1
84,1,1500,1621,8,121,1
43,2,2156,1621,5,535,1
103,2,1621,1093,4,528,1
92,1,1500,1621,6,121,1
29,2,1894,1621,4,273,1
33,1,1621,1894,12,273,1
14,2,1894,1621,9,273,1
17,1,1621,1894,4,273,1
14,2,1894,1621,12,273,1
22,1,1621,1894,17,273,1
32,1,1621,1903,6,282,1
52,1,1621,1500,10,121,0
27,2,1903,1621,4,282,1
48,1,1621,1903,4,282,1
39,2,1903,1621,4,282,1
81,1,1621,1903,15,282,1
34,1,1621,1804,7,183,1
34,2,1903,1621,4,282,1
88,1,1847,1944,9,97,1
64,1,2040,2334,6,294,1
48,0,1973,2040,11,67,0
115,2,1800,1973,8,173,0
48,0,1973,2040,11,67,0
19,2,1973,1505,4,468,1
51,2,1973,1765,1,208,1
82,1,2010,1973,5,37,0
58,2,1973,1522,5,451,1
36,1,2091,1958,2,133,0
116,1,1969,1969,15,0,0
71,2,1953,2141,7,188,0
62,1,1942,1942,11,0,0
51,2,1942,1500,4,442,1
17,2,1942,1500,7,442,1
69,2,1929,1983,8,54,0
44,1,1876,1919,10,43,1
32,0,1700,1925,2,225,0
137,0,1773,1930,2,157,0
53,2,1925,1696,6,229,1
53,0,1930,1762,5,168,0
124,1,1864,1921,3,57,1
24,1,1930,1988,10,58,1
83,2,2109,1936,17,173,1
80,1,1898,1926,9,28,1
73,2,1527,1608,9,81,0
34,1,1588,1527,8,61,0
42,1,1500,1527,3,27,1
58,1,1548,1527,8,21,0
35,2,1527,1500,3,27,1
57,2,1527,1500,12,27,1
128,1,1527,1290,4,237,0
93,2,1549,1527,6,22,1
61,2,1500,1527,5,27,0
84,1,2237,1742,5,495,0
78,1,2001,1395,6,606,0
74,1,1826,1970,3,144,1
126,1,1696,1967,2,271,1
72,1,1842,1967,2,125,1
66,1,1816,1960,4,144,1
50,1,1730,1955,3,225,1
57,2,1942,1993,7,51,0
52,1,1956,1864,7,92,0
76,1,1866,1948,14,82,1
89,2,1935,1968,9,33,0
25,2,1952,1946,7,6,1
62,1,1859,1938,3,79,1
30,1,1778,1938,4,160,1
67,2,1938,1778,4,160,1
37,2,1778,1938,4,160,0
21,1,1938,1924,11,14,0
66,2,1774,1954,3,180,0
30,2,1804,1954,3,150,0
55,2,1954,1955,9,1,0
32,1,1801,1947,10,146,1
49,2,1947,1937,10,10,1
56,2,1968,1958,3,10,1
56,1,1970,1957,6,13,0
38,1,2052,1956,5,96,0
41,2,1946,1912,7,34,1
72,1,1841,1937,2,96,1
23,2,1927,1892,11,35,1
67,2,1910,2080,9,170,0
76,1,1928,1723,9,205,0
54,1,1826,1919,3,93,1
94,1,1882,1909,3,27,1
57,2,1907,1499,2,408,1
39,2,1899,1790,7,109,1
65,2,1713,1553,8,160,1
96,2,1713,1553,8,160,1
37,2,1553,1713,6,160,0
97,2,1680,1572,3,108,1
135,2,1805,1721,6,84,1
98,1,1525,1605,11,80,1
44,2,1505,1559,6,54,0
44,1,1408,1371,11,37,0
93,2,1608,1500,6,108,1
80,1,1500,1500,3,0,0
45,2,2065,2043,18,22,1
24,1,1928,1879,7,49,0
96,1,1892,1846,13,46,0
55,2,1936,1906,6,30,1
73,2,1285,1936,9,651,0
19,2,1933,1564,6,369,1
48,1,1922,1917,13,5,0
35,2,1911,1675,15,236,1
51,2,1895,1895,19,0,0
39,2,1889,1618,7,271,1
170,1,2006,1889,7,117,0
51,2,1876,1807,5,69,1
58,1,1503,1873,7,370,1
45,2,1856,1858,8,2,0
50,1,1838,1839,10,1,1
42,1,1505,1907,2,402,1
37,2,1620,1682,12,62,0
85,1,1999,1988,10,11,0
171,2,1976,2010,5,34,0
63,2,2000,1986,10,14,1
84,1,1896,1992,7,96,1
65,2,1983,1904,11,79,1
113,2,1822,1992,5,170,0
67,2,1986,1828,4,158,1
68,1,1996,2011,7,15,1
85,2,1990,1825,4,165,1
120,1,2001,2005,5,4,1
134,1,2017,1989,2,28,0
110,0,2011,1989,3,22,0
51,1,2000,2000,11,0,0
89,2,1988,2011,11,23,0
43,2,1930,2016,6,86,0
136,1,1945,2006,7,61,1
86,1,2020,1932,9,88,0
96,1,1826,2015,6,189,1
56,1,2032,1810,4,222,0
68,1,1814,2027,6,213,1
46,1,1983,2027,13,44,1
95,2,2017,1989,5,28,1
82,1,2029,1987,4,42,0
49,2,2199,2035,7,164,1
102,0,2035,2045,3,10,0
32,1,1924,2027,5,103,1
101,2,2021,1871,2,150,1
135,1,1941,2012,18,71,1
107,2,2002,1950,5,52,1
112,1,1960,1992,7,32,1
39,2,1925,1753,2,172,1
55,2,1686,1767,3,81,0
49,2,1888,1775,10,113,1
26,1,1792,1619,5,173,0
75,2,1787,1549,9,238,1
2,1,1567,1782,1,215,1
2,2,1776,1572,1,204,1
2,1,1578,1771,1,193,1
2,1,1789,1560,1,229,0
2,2,1783,1565,1,218,1
27,2,1811,1794,7,17,1
148,0,1485,1802,3,317,0
2,1,1570,1797,1,227,1
2,2,1792,1575,1,217,1
2,2,1787,1581,1,206,1
2,2,1781,1587,1,194,1
2,2,1776,1593,1,183,1
2,1,1599,1769,1,170,1
2,2,1763,1606,1,157,1
2,1,1613,1756,2,143,1
2,2,1749,1620,1,129,1
2,2,1604,1765,1,161,0
28,1,1775,1786,5,11,1
2,2,1769,1625,2,144,1
2,2,1761,1632,2,129,1
2,2,1616,1777,1,161,0
2,2,1771,1623,2,148,1
2,2,1763,1630,2,133,1
37,2,1639,1779,2,140,0
24,1,1795,1618,7,177,0
14,1,1811,1631,1,180,0
39,2,1874,1833,3,41,1
152,1,1838,2053,5,215,1
74,1,1908,1825,9,83,0
34,1,1838,1761,9,77,0
115,1,1765,1829,3,64,1
117,2,1817,1856,9,39,0
92,1,1821,2067,13,246,1
94,1,1788,1811,1,23,1
90,1,1682,1804,4,122,1
57,2,1792,1796,9,4,0
56,1,1798,1685,6,113,0
92,1,1693,1789,7,96,1
125,2,2018,1794,5,224,1
47,2,1701,1809,9,108,0
72,1,1644,1802,5,158,1
43,0,1800,1881,5,81,0
100,1,1811,1808,7,3,0
44,1,1525,1538,7,13,1
40,1,1538,1513,7,25,0
57,2,1585,1549,8,36,1
60,1,1519,1538,3,19,1
28,1,1549,1589,3,40,1
86,1,1512,1524,8,12,1
56,1,1528,1805,5,277,1
91,2,1796,1533,6,263,1
51,2,1486,1973,11,487,0
20,1,1478,1625,11,147,1
57,2,1473,1196,5,277,1
102,1,1518,1458,8,60,0
43,2,1445,1445,5,0,0
81,2,1535,1455,2,80,1
131,2,1641,1463,3,178,1
39,2,1569,1472,10,97,1
42,1,1489,1401,4,88,0
11,2,1941,1491,1,450,1
152,0,1485,1661,14,176,0
34,1,1489,1798,8,309,1
43,2,1806,1493,6,313,1
95,1,1509,1478,2,31,0
73,1,1496,1389,6,107,0
33,1,991,1495,6,504,1
31,2,1924,1497,12,427,1
84,1,1498,2044,3,546,1
57,2,1476,1746,10,270,0
106,1,1489,1501,9,12,1
98,1,1358,1479,1,121,1
107,2,1470,1341,11,129,1
118,1,1485,1473,5,12,0
83,2,1802,1489,3,313,1
101,2,1474,1489,13,15,0
19,2,1562,1486,3,76,1
20,2,2700,1486,8,1214,1
63,2,1494,1502,2,8,0
95,2,1529,1517,5,12,1
100,1,1529,1622,7,93,1
30,1,1532,1956,2,424,1
40,1,1532,1514,3,18,0
42,1,1520,1794,7,274,1
120,0,1500,1885,5,385,0
68,1,1047,1231,4,184,1
15,2,1226,1084,3,142,1
40,1,911,1226,5,315,1
23,2,1226,870,2,356,1
45,2,1073,1226,2,153,0
36,1,1106,1218,5,112,1
49,2,1213,983,7,230,1
55,2,1081,1228,5,147,0
43,2,1221,1095,2,126,1
22,1,1152,1221,3,69,1
32,1,1164,1221,5,57,1
77,2,1221,1173,2,48,1
41,2,1111,1236,5,125,0
53,2,1236,1023,2,213,1
70,1,1023,1236,3,213,1
79,2,1236,964,3,272,1
34,1,1253,1236,3,17,0
40,1,1236,1500,4,264,1
51,2,1231,997,5,234,1
17,2,1073,1231,5,158,0
39,2,1311,1231,5,80,1
33,2,1221,1173,4,48,1
36,2,954,1240,2,286,0
38,1,1096,1233,3,137,1
15,2,1218,1233,5,15,0
37,2,1225,1104,2,121,1
41,2,1796,1838,3,42,0
69,2,1946,1847,4,99,1
51,2,1841,1657,11,184,1
71,1,1677,1834,3,157,1
85,2,1834,1802,8,32,1
56,1,1844,1884,13,40,1
95,2,2058,1849,5,209,1
80,1,1863,1794,7,69,0
69,2,1863,1760,10,103,1
83,1,1880,1851,8,29,0
103,2,1837,1893,8,56,0
151,2,1882,1848,8,34,1
120,1,1857,1938,8,81,1
129,2,1846,1879,11,33,0
60,1,1775,1836,4,61,1
106,1,1188,1500,7,312,1
24,1,1198,1677,9,479,1
29,1,1198,1336,6,138,1
53,2,1514,1226,5,288,1
25,2,1402,1226,2,176,1
19,2,1494,1270,2,224,1
44,1,1371,1432,5,61,1
10,1,1500,1371,5,129,0
28,1,1371,1615,5,244,1
7,0,1670,1500,7,170,0
67,2,1500,1490,5,10,1
73,0,1592,1478,1,114,0
50,1,1540,1582,7,42,1
20,1,1591,1673,4,82,1
53,2,1576,1375,4,201,1
40,1,1588,1583,4,5,0
118,0,1764,1584,5,180,0
89,2,1573,1553,12,20,1
49,1,1398,1566,3,168,1
99,0,1434,1571,4,137,0
29,2,1565,1346,3,219,1
109,2,1324,1585,3,261,0
51,2,1583,1150,7,433,1
76,1,1712,1583,3,129,0
98,1,1520,1573,7,53,1
11,2,1887,1295,7,592,1
54,1,1296,1886,4,590,1
42,1,1913,1275,2,638,0
43,2,1908,1633,4,275,1
73,1,1931,1626,3,305,0
154,1,1952,1725,3,227,0
82,1,1451,1950,11,499,1
45,2,1855,1968,2,113,0
69,2,2238,1972,5,266,1
129,2,1962,1889,8,73,1
57,2,1396,1131,4,265,1
19,2,1237,1565,9,328,0
98,1,1753,1451,4,302,0
35,2,1699,1457,4,242,1
41,2,1699,1500,8,199,1
75,2,1500,1545,3,45,0
71,2,1803,1387,5,416,1
48,1,1559,1798,3,239,1
109,2,1787,1766,7,21,1
12,1,1598,1743,4,145,1
8,1,1605,1735,2,130,1
8,1,1614,1727,2,113,1
49,2,1509,1629,7,120,0
20,1,1474,1500,7,26,1
12,0,1752,1500,5,252,0
108,0,2068,2228,7,160,0
30,1,2072,2499,6,427,1
81,1,2089,2153,13,64,1
7,2,2192,2106,4,86,1
58,0,2263,2096,12,167,0
95,2,2209,2113,4,96,1
45,2,2085,2161,9,76,0
36,2,2134,2071,5,63,1
71,2,2026,2224,3,198,0
119,2,1985,2091,6,106,0
75,2,1940,2045,9,105,0
40,0,2028,1940,8,88,0
41,2,2153,1959,4,194,1
61,1,1934,1917,4,17,0
51,1,1917,1804,7,113,0
54,1,1966,1859,4,107,0
87,2,1809,1802,8,7,1
62,1,1859,1728,8,131,0
69,1,1783,1858,3,75,1
169,2,1868,1868,6,0,0
34,1,1634,1807,2,173,1
67,2,1991,1929,4,62,1
99,2,1500,1855,9,355,0
13,1,1392,1333,7,59,0
57,2,1392,1343,1,49,1
38,1,1353,1382,5,29,1
54,1,1102,1353,5,251,1
35,2,1353,1522,8,169,0
79,2,1510,1353,9,157,1
69,2,1265,1367,4,102,0
31,2,1434,1377,4,57,1
198,1,1246,1340,4,94,1
18,1,1347,1495,5,148,1
18,1,1355,1470,3,115,1
51,2,1359,1366,7,7,0
45,0,1370,1228,7,142,0
36,2,1351,1374,7,23,0
81,1,1141,1369,3,228,1
87,2,1363,1201,5,162,1
68,1,1283,1354,3,71,1
111,2,1347,1186,7,161,1
27,2,1334,1400,3,66,0
19,1,1348,1322,6,26,0
27,1,1329,1466,3,137,1
25,2,1295,1821,4,526,0
102,1,1329,1282,7,47,0
60,1,1285,1598,3,313,1
62,1,1099,1279,3,180,1
130,0,1275,1398,3,123,0
61,2,1350,1285,7,65,1
63,2,1383,1286,7,97,1
50,1,1297,1313,5,16,1
26,1,1273,1286,8,13,1
33,2,1282,1018,5,264,1
17,2,1231,1295,11,64,0
32,1,1306,1298,8,8,0
92,1,1195,1298,1,103,1
47,2,1383,1307,4,76,1
25,2,1296,1284,3,12,1
71,2,1600,1300,6,300,1
57,2,1282,1492,4,210,0
43,0,1386,1279,1,107,0
17,2,1264,1367,6,103,0
71,2,1539,1514,5,25,1
23,2,1528,1544,3,16,0
114,1,1539,1514,3,25,0
54,1,1506,1529,6,23,1
114,1,1541,1528,2,13,0
44,0,2158,2140,6,18,0
51,2,2140,2158,15,18,0
33,2,2158,2140,9,18,1
64,1,2170,2110,4,60,0
53,2,2170,1510,8,660,1
58,1,1510,2170,2,660,1
36,1,2170,1701,3,469,0
83,2,2164,2014,3,150,1
71,2,2155,2078,10,77,1
114,1,2033,2148,2,115,1
56,1,2161,2077,2,84,0
42,1,2086,2152,8,66,1
53,2,2145,2013,8,132,1
109,2,2311,2151,11,160,1
45,2,2210,2161,11,49,1
73,2,1646,1522,4,124,1
170,0,1636,1858,5,222,0
41,2,1611,1640,5,29,0
124,0,1646,1528,4,118,0
33,2,1715,1648,5,67,1
40,1,1650,1709,4,59,1
100,1,1554,1630,1,76,1
101,2,1763,1649,8,114,1
85,2,1615,1685,4,70,0
81,2,1582,1626,7,44,0
57,2,1543,1614,4,71,0
31,2,1605,1576,3,29,1
66,1,1622,1543,4,79,0
26,0,1546,1632,5,86,0
80,1,1666,1770,5,104,1
92,1,1655,1604,2,51,0
110,1,1522,1543,9,21,1
79,2,1443,1598,2,155,0
15,2,1547,1522,3,25,1
68,1,1657,1609,4,48,0
123,2,1500,1461,6,39,1
38,1,1444,1834,1,390,1
115,2,1831,1458,1,373,1
114,1,1476,1828,2,352,1
57,2,1824,1498,3,326,1
54,1,1527,1819,1,292,1
69,2,1814,1567,1,247,1
4,1,1834,1332,1,502,0
132,1,1349,1832,3,483,1
55,2,1830,1369,1,461,1
54,1,1396,1827,1,431,1
125,2,1824,1433,1,391,1
72,1,1500,1821,1,321,1
58,1,1743,1800,12,57,1
71,2,1849,1752,2,97,1
55,2,1737,1833,5,96,0
71,2,1731,1560,5,171,1
48,1,1628,1729,8,101,1
77,2,1724,1534,2,190,1
218,1,1632,1715,9,83,1
2,1,1039,1161,2,122,1
2,1,1055,1280,1,225,1
8,1,1086,1148,1,62,1
62,1,1091,1958,1,867,1
4,1,1091,1171,1,80,1
2,1,1091,1529,1,438,1
2,2,1091,1701,1,610,0
2,1,1091,1500,1,409,1
5,2,1674,1095,1,579,1
15,2,1907,1095,4,812,1
26,1,1185,1171,1,14,0
38,1,1193,1636,1,443,1
69,2,1733,1199,3,534,1
44,1,1236,1373,1,137,1
37,2,2047,1236,3,811,1
64,1,1264,1506,1,242,1
89,2,1859,1734,4,125,1
108,0,2305,2143,11,162,0
93,2,2204,2160,3,44,1
77,2,2132,2263,13,131,0
53,2,2094,2416,6,322,0
51,2,2445,2094,2,351,1
93,2,2060,2255,10,195,0
39,2,2243,2060,7,183,1
52,2,1791,2516,4,725,0
15,2,1083,985,2,98,1
33,0,1074,1197,4,123,0
32,1,1085,1347,4,262,1
28,1,1085,1744,4,659,1
32,0,1002,1092,4,90,0
40,1,1118,1205,8,87,1
95,2,1102,878,4,224,1
28,1,1154,1155,4,1,1
57,2,1273,1199,1,74,1
23,1,1331,1324,8,7,0
45,0,1500,1420,1,80,0
6,1,1500,1628,1,128,1
52,1,1500,1302,1,198,0
3,0,1500,1626,2,126,0
7,2,1200,1500,6,300,0
4,0,1454,1500,2,46,0
31,2,1339,1500,2,161,0
78,1,1758,1696,11,62,0
91,2,1696,1500,4,196,1
120,1,1704,1815,10,111,1
48,1,1402,1700,6,298,1
93,2,1500,1700,6,200,0
61,2,1700,1811,4,111,0
17,1,1475,1455,3,20,0
54,1,1478,1463,10,15,0
29,2,1456,1403,3,53,1
121,2,1442,1181,6,261,1
37,1,1358,1433,6,75,1
68,1,1433,2621,6,1188,1
84,1,1443,1469,10,26,1
136,0,1308,1448,2,140,0
106,2,1439,1341,5,98,1
70,1,1396,1429,3,33,1
44,1,1282,1421,2,139,1
51,2,1570,1585,5,15,0
50,1,1605,1558,8,47,0
39,2,1546,1600,5,54,0
90,1,1579,1534,1,45,0
91,2,1523,1535,6,12,0
119,2,1534,1530,5,4,1
83,1,1539,1582,2,43,1
112,1,1538,1529,2,9,0
134,0,1529,1531,6,2,0
55,2,1559,1539,4,20,1
74,1,1549,1549,6,0,0
122,0,1529,1550,4,21,0
120,1,1553,1539,3,14,0
60,1,1549,1527,3,22,0
45,2,1553,1538,4,15,1
150,1,1540,1536,4,4,0
61,2,1618,1545,3,73,1
95,2,1533,1573,6,40,0
94,1,1538,1534,4,4,0
76,1,2030,1841,8,189,0
26,1,2030,1225,2,805,0
42,2,1855,2030,4,175,0
86,1,2030,2202,4,172,1
99,2,2030,1841,4,189,1
26,1,2030,1841,8,189,0
52,1,2030,1641,8,389,0
59,1,2030,2168,18,138,1
52,1,2030,1491,10,539,0
34,1,2030,1767,3,263,0
39,2,1486,1092,3,394,1
93,2,1417,1500,7,83,0
29,2,1493,1342,5,151,1
66,1,1349,1486,4,137,1
84,2,1363,1501,8,138,0
67,2,1491,1461,3,30,1
62,1,1420,1473,7,53,1
81,1,1490,1317,6,173,0
63,2,1488,1067,2,421,1
96,1,1339,1481,1,142,1
8,2,1332,1498,3,166,0
99,2,1500,1510,5,10,0
44,1,1517,1661,3,144,1
47,1,1524,1654,4,130,1
15,2,1551,1535,10,16,1
88,1,1548,1540,5,8,0
63,2,2131,1431,4,700,1
54,2,1426,1447,12,21,0
50,1,1485,1403,6,82,0
44,1,1401,1382,3,19,0
37,1,1392,1608,5,216,1
21,2,1603,1402,9,201,1
149,2,1402,1341,8,61,1
94,1,1116,1402,2,286,1
61,2,1116,1402,2,286,0
21,2,1116,1402,13,286,0
50,1,1116,1402,8,286,1
30,1,1402,1116,4,286,0
55,2,1402,1569,2,167,0
57,2,1737,1408,13,329,1
48,1,1431,1426,2,5,0
21,1,1455,1448,2,7,0
35,2,1859,1460,5,399,1
43,2,1501,1484,2,17,1
111,2,1457,1449,2,8,1
49,2,1419,1544,2,125,0
40,1,1419,1865,2,446,1
57,1,1433,1653,2,220,1
14,2,1781,1441,4,340,1
5,2,1473,1532,2,59,0
19,2,1453,1561,1,108,0
36,0,1509,1400,2,109,0
57,2,1340,1400,1,60,0
134,1,1400,1340,2,60,0
33,2,1500,1482,3,18,1
29,2,1412,1705,1,293,0
102,1,1561,1500,1,61,0
40,1,1468,1648,3,180,1
75,2,1631,1711,8,80,0
9,2,1630,1130,6,500,1
76,1,1197,1628,2,431,1
76,1,1243,1625,8,382,1
86,1,1250,1622,4,372,1
73,2,1500,1633,3,133,0
17,2,1624,1526,11,98,1
20,1,1537,1613,9,76,1
58,2,1602,1549,11,53,1
59,2,1595,1411,10,184,1
54,1,1117,1593,5,476,1
112,1,1290,1589,3,299,1
31,2,1585,1294,3,291,1
57,2,1348,1606,3,258,0
77,2,1599,1424,5,175,1
38,1,1433,1599,9,166,1
65,2,1599,1315,11,284,1
30,1,1315,1599,7,284,1
88,1,1468,1590,9,122,1
97,2,1584,1359,4,225,1
62,0,1509,1587,6,78,0
21,2,1311,1611,11,300,0
47,2,1611,1299,10,312,1
35,1,1299,1611,7,312,1
80,0,1727,1606,10,121,0
45,2,1586,1742,8,156,0
42,1,1288,1582,4,294,1
55,2,1559,1797,8,238,0
56,1,1754,1537,7,217,0
103,2,1515,1719,8,204,0
34,2,1507,1318,4,189,1
32,1,1515,1710,8,195,1
85,2,1680,1516,11,164,1
100,1,1525,1674,8,149,1
34,1,1500,1497,8,3,0
20,0,1577,1692,8,115,0
61,2,1704,1380,11,324,1
47,2,1704,1380,8,324,1
61,2,1702,1266,6,436,1
59,2,1702,1380,8,322,1
26,1,1702,1380,8,322,0
44,1,1702,1380,8,322,0
59,2,1702,1380,6,322,1
39,2,1702,1380,6,322,1
47,2,1702,1380,11,322,1
53,2,1702,1380,11,322,1
50,1,1702,1380,11,322,0
74,1,871,1701,3,830,1
49,2,1698,1384,9,314,1
78,1,1709,1735,2,26,1
45,2,1709,1384,2,325,1
55,1,1709,1384,2,325,0
38,1,1384,1709,10,325,1
24,2,1709,1384,6,325,1
34,1,1384,1709,11,325,1
72,1,1721,1757,3,36,1
64,2,1524,1741,1,217,0
57,2,1766,1753,5,13,1
51,2,1518,1774,2,256,0
86,1,1905,1896,5,9,0
37,2,1871,1940,3,69,0
122,1,1977,2012,7,35,1
10,2,1971,1244,7,727,1
97,2,1213,1813,2,600,0
117,2,1184,1506,4,322,0
32,1,1186,1745,4,559,1
21,2,1569,1189,9,380,1
70,1,1199,1329,5,130,1
12,2,1288,1674,2,386,0
38,1,1674,1748,2,74,1
45,2,2186,2169,5,17,1
111,2,2178,2073,5,105,1
205,0,2382,2173,3,209,0
61,2,2165,2066,2,99,1
207,0,2165,2158,4,7,0
62,1,2169,2153,7,16,0
5,2,2141,2180,2,39,0
85,0,2181,2140,13,41,0
106,1,2150,2171,2,21,1
102,1,2183,2138,13,45,0
70,1,1499,1449,5,50,0
66,1,1909,1639,3,270,0
61,2,1853,1923,1,70,0
69,2,2121,1929,9,192,1
74,1,1935,2124,7,189,1
94,1,1916,1924,5,8,1
75,2,1916,1791,4,125,1
92,1,1931,1749,3,182,0
76,1,1643,1927,1,284,1
58,2,1801,1943,9,142,0
119,2,1942,1466,8,476,1
70,1,1957,1820,7,137,0
121,2,1933,1970,4,37,0
75,2,2016,1980,2,36,1
109,2,1969,1971,6,2,0
87,2,2168,1975,11,193,1
77,2,1968,1817,2,151,1
87,2,1961,1805,12,156,1
91,2,1746,1979,5,233,0
50,1,1878,1971,8,93,1
29,2,2086,1979,8,107,1
117,1,1992,1941,5,51,0
47,2,1981,1977,4,4,1
150,1,1880,1972,2,92,1
10,2,1971,1244,7,727,1
108,1,1452,1970,3,518,1
42,1,1976,2152,5,176,1
87,2,1970,1785,5,185,1
69,2,2107,1978,3,129,1
94,1,1981,2303,5,322,1
56,1,1941,1971,4,30,1
47,2,1953,2149,12,196,0
113,2,2287,1956,10,331,1
91,2,1890,1887,5,3,1
70,1,1516,1887,3,371,1
55,2,1886,1223,5,663,1
101,2,2312,1888,2,424,1
76,1,1807,1879,2,72,1
41,2,1872,1733,4,139,1
50,1,1878,2062,8,184,1
84,1,1910,1864,7,46,0
109,2,1855,1791,9,64,1
69,2,1838,1986,6,148,0
44,1,1602,1828,5,226,1
70,1,1673,1828,2,155,1
45,2,1828,1500,2,328,1
27,2,1500,1828,8,328,0
46,1,1848,1559,4,289,0
53,2,1815,1878,4,63,0
27,2,2193,1892,7,301,1
99,2,1777,1908,8,131,0
85,2,1902,1706,4,196,1
67,2,1899,1512,6,387,1
96,1,1805,1890,6,85,1
82,1,1903,1896,5,7,0
48,1,1677,1897,8,220,1
54,1,1900,2246,4,346,1
112,1,1460,1427,2,33,0
33,2,1426,987,4,439,1
59,2,1421,1186,5,235,1
119,2,1417,1432,11,15,0
123,2,1428,1150,4,278,1
46,1,1415,1418,8,3,1
45,2,1405,1486,5,81,0
41,2,1383,1464,11,81,0
55,2,1317,1383,8,66,0
63,2,1375,1269,4,106,1
89,2,1363,1418,6,55,0
71,2,1392,1373,6,19,1
75,2,2234,2361,13,127,0
43,2,2232,1652,10,580,1
54,1,1826,2228,5,402,1
94,1,2052,2217,9,165,1
40,2,2211,1871,6,340,1
93,1,1814,2207,5,393,1
110,1,2025,2194,4,169,1
77,2,2193,1511,11,682,1
74,1,1516,2192,4,676,1
43,2,2189,1773,8,416,1
118,1,1969,2178,6,209,1
102,1,2023,2163,5,140,1
62,2,2147,2031,9,116,1
66,1,1657,2143,5,486,1
22,2,2141,1578,7,563,1
81,2,2140,1521,6,619,1
62,1,1834,2132,9,298,1
46,1,1529,2130,12,601,1
105,2,2048,2150,10,102,0
48,1,1792,2146,6,354,1
60,1,2167,1978,6,189,0
50,2,2161,1923,7,238,1
54,1,1656,2160,8,504,1
96,1,1541,2159,5,618,1
63,2,2152,1950,3,202,1
21,2,2159,1749,9,410,1
69,2,2376,2166,9,210,1
71,2,2151,2167,7,16,0
56,1,2084,2140,3,56,1
38,1,2032,2129,9,97,1
51,2,2126,1794,7,332,1
57,2,2120,1887,3,233,1
26,1,1927,2112,5,185,1
179,0,1814,2122,3,308,0
61,2,2102,2255,2,153,0
67,2,2101,1587,7,514,1
22,1,1491,2100,5,609,1
15,2,2187,2111,2,76,1
77,0,2115,2021,4,94,0
216,0,2393,2438,6,45,0
51,2,2438,2146,5,292,1
1,2,2438,1666,1,772,1
79,0,2438,1658,9,780,0
60,0,2438,1692,5,746,0
1,2,2438,1885,1,553,1
23,2,2438,946,2,1492,1
44,1,2351,2414,12,63,1
110,1,2230,2396,9,166,1
147,0,1958,1978,2,20,0
72,1,1834,1963,3,129,1
65,2,1948,1809,5,139,1
127,2,1962,1973,7,11,0
39,2,1822,2012,7,190,0
117,2,1993,1887,8,106,1
56,1,2018,2063,13,45,1
52,1,1641,2011,5,370,1
67,2,2192,2030,5,162,1
128,1,2067,2040,15,27,0
142,1,1782,2054,8,272,1
133,2,2034,1835,5,199,1
43,2,1959,1953,9,6,1
147,2,1922,1798,11,124,1
48,1,1911,1844,7,67,0
50,1,1787,1757,3,30,0
67,2,1710,1499,8,211,1
19,2,1519,1135,7,384,1
16,2,1752,1519,3,233,1
64,1,1519,1752,5,233,1
65,2,1519,1304,4,215,1
28,2,1519,1445,9,74,1
34,1,1165,1504,5,339,1
52,1,1800,1023,4,777,0
48,1,1804,1789,3,15,0
87,2,1777,1807,6,30,0
60,1,1782,2015,13,233,1
52,2,1961,1788,5,173,1
46,1,1622,1781,2,159,1
31,1,1727,1760,7,33,1
55,2,1750,1737,9,13,1
82,2,1698,1753,4,55,0
21,1,1762,1842,4,80,1
32,1,1336,1275,3,61,0
43,1,1295,1311,6,16,1
81,1,1325,1379,6,54,1
31,2,1302,1293,6,9,1
27,2,1431,1320,6,111,1
42,2,1333,1347,3,14,0
46,2,1345,1340,7,5,1
124,1,1444,1300,7,144,0
46,1,1331,1374,2,43,1
85,2,1387,1368,2,19,1
39,2,1419,1425,4,6,0
38,1,1263,1387,4,124,1
53,2,1433,1458,5,25,0
63,2,1372,1393,5,21,0
37,2,1332,1081,8,251,1
114,0,1309,1375,5,66,0
116,1,2068,2100,5,32,1
67,2,2068,1906,4,162,1
35,2,1818,2068,5,250,0
22,0,2004,2068,6,64,0
66,1,1937,2068,13,131,1
130,1,1814,2068,3,254,1
109,2,2068,2035,6,33,1
25,2,1959,1944,14,15,1
143,2,1936,1812,8,124,1
139,0,1941,1775,8,166,0
49,1,1950,2027,5,77,1
62,1,1966,1777,7,189,0
36,1,1783,1960,12,177,1
108,1,2052,1946,11,106,0
105,2,1931,2067,7,136,0
24,1,1939,2060,9,121,1
51,2,1998,1948,3,50,1
82,1,1033,1469,6,436,1
54,1,1038,1380,5,342,1
81,2,1521,1040,4,481,1
66,1,1014,1328,5,314,1
61,2,1129,1014,5,115,1
66,1,1029,1084,5,55,1
50,2,908,1055,2,147,0
57,2,1055,1163,4,108,0
41,2,1024,1281,2,257,0
61,2,1024,1151,6,127,0
70,1,1037,1167,2,130,1
93,2,1129,1052,5,77,1
42,1,1061,1030,4,31,0
9,1,1080,1003,4,77,0
53,2,979,1011,3,32,0
52,1,985,1323,4,338,1
55,1,1011,953,5,58,0
37,2,1177,1052,2,125,1
80,1,1073,1170,4,97,1
50,1,1097,1192,6,95,1
45,2,1256,1120,2,136,1
49,2,1248,1149,2,99,1
60,1,1149,2013,5,864,1
47,2,2013,1149,4,864,1
69,2,1405,1149,5,256,1
18,1,1149,1405,5,256,1
57,2,1855,1915,13,60,0
34,0,1890,1734,7,156,0
45,2,1890,2002,6,112,0
53,2,1810,1723,11,87,1
51,2,1727,1562,4,165,1
44,1,1634,1500,2,134,0
41,2,1500,1500,2,0,0
27,2,1823,1600,5,223,1
64,1,2015,2043,5,28,1
81,2,2031,2026,7,5,1
63,2,2030,1400,4,630,1
49,2,1985,2044,15,59,0
138,1,2214,2253,5,39,1
91,2,2202,2213,8,11,0
34,1,2211,2300,4,89,1
93,2,2194,2384,5,190,0
92,1,2131,2185,16,54,1
98,1,1573,2184,4,611,1
109,2,2170,2266,6,96,0
78,0,2270,2167,3,103,0
80,1,2289,2152,6,137,0
77,2,2142,2104,4,38,1
166,1,2008,2135,2,127,1
47,2,2126,2072,7,54,1
71,1,2136,2170,6,34,1
60,1,1952,2130,4,178,1
55,2,1940,1847,7,93,1
27,2,1934,1726,6,208,1
96,1,1994,1919,14,75,0
81,1,1934,1881,6,53,0
90,1,1784,1926,10,142,1
54,1,1843,1915,7,72,1
105,2,1906,1792,8,114,1
83,2,1899,1720,1,179,1
76,1,1335,1898,7,563,1
89,2,1893,1649,5,244,1
35,2,1887,1665,3,222,1
80,1,1765,1878,2,113,1
84,1,1715,1870,11,155,1
37,2,1866,1521,1,345,1
100,1,1646,1860,9,214,1
68,1,1880,1707,3,173,0
25,2,1856,2190,12,334,0
70,1,1559,1852,9,293,1
153,0,1849,1919,7,70,0
1,1,1878,1860,1,18,0
85,2,1955,1890,11,65,1
81,1,1902,1952,12,50,1
102,1,1629,1897,9,268,1
62,1,1758,1887,11,129,1
35,2,1886,1345,6,541,1
124,1,1856,1872,5,16,1
61,2,2060,1910,8,150,1
72,1,1981,1941,8,40,0
41,2,1924,1905,7,19,1
57,2,1892,1945,3,53,0
37,2,1859,1969,5,110,0
17,1,1985,2047,1,62,1
6,2,1959,2008,5,49,0
2,1,2029,2025,2,4,0
7,1,2058,1945,4,113,0
97,2,1929,2090,5,161,0
67,2,2076,1922,12,154,1
71,0,2080,2032,8,48,0
138,0,1944,2090,3,146,0
40,1,1795,1760,5,35,0
111,2,1729,1795,5,66,0
54,1,1795,1784,6,11,0
33,2,1770,1872,3,102,0
90,1,1783,1721,5,62,0
90,1,1884,1768,7,116,0
40,1,1756,1756,5,0,0
49,2,1724,1958,5,234,0
50,1,2036,1706,6,330,0
59,2,1706,925,5,781,1
104,1,1389,1307,5,82,0
33,2,1678,1299,10,379,1
64,1,1152,1299,3,147,1
62,1,1303,1634,6,331,1
47,2,1278,1530,6,252,0
30,2,1595,1281,6,314,1
24,2,1267,1344,8,77,0
20,2,1332,1277,8,55,1
66,1,1213,1277,8,64,1
12,1,1277,1047,3,230,0
63,1,1047,1277,3,230,1
82,2,1393,1285,3,108,1
87,2,1279,1090,2,189,1
19,2,1268,1255,4,13,1
59,2,1186,1283,3,97,0
124,1,1283,1267,5,16,0
96,1,1290,1270,1,20,0
53,2,1331,1281,4,50,1
39,2,1304,1292,1,12,1
10,1,1305,1293,3,12,0
51,2,1308,1317,8,9,0
18,1,1296,1305,13,9,1
106,1,968,1305,8,337,1
38,1,1293,1466,5,173,1
59,2,1500,1299,7,201,1
111,2,1288,1232,3,56,1
28,1,1289,2108,9,819,1
101,2,1431,1289,6,142,1
15,2,1806,1289,7,517,1
42,2,1289,1311,5,22,0
118,1,1431,1289,3,142,0
34,1,1289,1484,6,195,1
60,1,1289,1810,5,521,1
66,1,1806,1289,5,517,0
21,2,1289,1500,5,211,0
73,2,1409,1297,8,112,1
159,2,1280,1485,6,205,0
74,2,1280,1211,4,69,1
28,1,1211,1280,3,69,1
112,1,1281,1765,6,484,1
86,1,1813,1796,14,17,0
56,1,1810,1720,10,90,0
125,2,1798,1836,7,38,0
55,2,1795,1831,5,36,0
112,1,1809,1729,2,80,0
64,1,1816,1956,3,140,1
55,2,1803,1839,10,36,0
175,2,1767,1816,3,49,0
56,1,1759,1806,5,47,1
37,2,1529,1826,4,297,0
156,0,1819,2071,19,252,0
81,2,1808,1798,6,10,1
67,2,1819,1819,3,0,0
86,1,1832,1807,6,25,0
70,1,1878,1819,3,59,0
106,1,1661,1819,3,158,1
56,1,1703,1810,5,107,1
39,2,1809,1184,4,625,1
100,1,1823,1766,5,57,0
117,2,1815,1683,6,132,1
63,2,1797,2024,13,227,0
86,1,1892,1782,3,110,0
80,1,1777,1769,5,8,0
69,2,1767,1356,5,411,1
71,2,1767,1226,1,541,1
81,2,1226,1767,6,541,0
59,1,1228,1766,4,538,1
109,2,1766,1218,11,548,1
34,1,1219,1765,4,546,1
113,2,1989,1770,12,219,1
134,1,1776,1984,9,208,1
103,2,1928,1782,3,146,1
53,2,1770,1803,5,33,0
47,2,1852,1779,5,73,1
54,1,1789,1842,5,53,1
143,2,1832,1799,2,33,1
24,1,1973,1782,2,191,0
33,2,1767,1875,5,108,0
67,2,1755,1778,8,23,0
53,2,1738,1911,6,173,0
54,1,1824,1724,4,100,0
49,1,1812,1709,5,103,0
30,1,1715,1886,8,171,1
41,2,1481,1734,3,253,0
62,1,1750,1721,13,29,0
118,1,1842,1705,4,137,0
66,1,1709,2015,8,306,1
10,2,2454,1848,4,606,1
43,2,1848,2272,8,424,0
61,2,1557,1536,5,21,1
85,2,1536,1500,4,36,1
45,2,1482,1536,5,54,0
23,2,1500,1536,7,36,0
36,1,1536,1480,7,56,0
144,1,1536,1500,5,36,0
88,1,1500,1536,3,36,1
45,2,1536,1414,3,122,1
40,1,1414,1536,5,122,1
30,1,1536,1500,4,36,0
23,2,1536,1500,6,36,1
196,1,1401,1536,3,135,1
59,2,1536,1500,6,36,1
61,2,1536,1500,8,36,1
58,1,1536,1500,4,36,0
15,2,1500,1536,9,36,0
51,2,1589,1536,2,53,1
55,2,1536,1589,3,53,0
55,2,1469,1536,8,67,0
62,1,1536,1469,2,67,0
74,1,1536,1425,3,111,0
134,1,1536,1550,5,14,1
87,2,1550,1536,9,14,1
54,1,1536,1550,3,14,1
189,2,1550,1536,5,14,1
66,1,1536,1550,7,14,1
79,2,1550,1536,6,14,1
58,1,1536,1500,6,36,0
21,1,1536,1557,3,21,1
148,1,1500,1536,3,36,1
43,2,1536,1542,4,6,0
58,1,1542,1536,3,6,0
103,2,1536,1542,2,6,0
104,1,1690,1730,17,40,1
106,1,1010,1730,1,720,1
31,2,1729,1012,10,717,1
12,1,1014,1728,8,714,1
96,1,2384,2199,4,185,0
63,2,2212,2231,3,19,0
349,2,2194,2240,13,46,0
157,2,2162,2122,7,40,1
23,2,2426,2178,9,248,1
64,1,2196,2420,10,224,1
46,2,2413,2219,10,194,1
67,1,2247,2405,10,158,1
69,2,1832,1452,2,380,1
50,1,1452,1832,4,380,1
87,2,1832,1452,2,380,1
45,2,1473,1462,2,11,1
24,1,1246,1457,2,211,1
25,2,1451,1327,2,124,1
32,1,1460,1513,5,53,1
78,1,1468,1539,2,71,1
26,1,1617,1453,3,164,0
29,1,1446,1430,1,16,0
60,1,1379,1421,3,42,1
47,2,1417,1140,2,277,1
44,1,1478,1404,2,74,0
63,2,1393,1409,4,16,0
73,1,1403,1424,2,21,1
61,2,1405,1414,7,9,0
51,2,1406,1325,2,81,1
109,2,1394,1424,2,30,0
31,1,1437,1382,2,55,0
39,2,1372,1343,2,29,1
66,1,1298,1363,2,65,1
10,1,1337,1352,8,15,1
89,2,1343,1303,1,40,1
50,2,1356,1353,3,3,1
14,1,1362,1446,3,84,1
77,1,1369,1508,2,139,1
34,1,1383,1299,3,84,0
151,2,1369,1395,3,26,0
42,2,1387,1268,5,119,1
24,1,1241,1380,5,139,1
104,1,1243,1361,2,118,1
82,1,1373,1367,4,6,0
71,2,1361,1361,3,0,0
51,2,1382,1373,4,9,1
39,2,1333,1386,3,53,0
88,1,1398,1376,3,22,0
40,1,1387,1386,3,1,0
45,1,1396,1457,4,61,1
107,2,1383,1420,3,37,0
54,1,1350,1372,3,22,1
34,1,1385,1355,3,30,0
70,1,1237,1378,5,141,1
43,2,1402,1389,5,13,1
35,2,1382,1242,2,140,1
39,0,1382,1373,2,9,0
47,2,1477,1392,1,85,1
63,2,1378,1406,7,28,0
40,2,1329,1424,9,95,0
129,2,1284,1446,2,162,0
90,1,1387,1436,4,49,1
45,2,1430,1282,5,148,1
118,1,1453,1380,5,73,0
49,2,1446,1317,7,129,1
64,1,1459,1392,4,67,0
42,1,1434,1449,11,15,1
35,2,2621,1449,9,1172,1
34,0,1151,1424,2,273,0
25,2,1151,1424,4,273,0
40,2,1329,1424,9,95,0
20,2,1149,1424,3,275,0
98,0,1426,1357,1,69,0
37,2,1149,1426,7,277,0
70,1,1621,1579,5,42,0
60,1,1608,1610,2,2,1
53,2,1597,1630,6,33,0
66,2,1620,1609,6,11,1
80,1,1618,1687,2,69,1
53,2,1608,1568,5,40,1
111,0,1595,1517,2,78,0
50,1,1516,1586,7,70,1
22,1,1514,1576,4,62,1
83,2,1564,1549,2,15,1
109,2,1551,1562,2,11,0
61,2,1536,1610,4,74,0
61,2,1569,1548,7,21,1
63,2,1535,1556,2,21,0
43,2,1521,1543,5,22,0
61,2,1536,1535,2,1,1
98,1,1543,1682,10,139,1
107,0,1645,1539,2,106,0
94,1,1554,1529,6,25,0
86,1,1577,1538,2,39,0
31,2,1522,1583,7,61,0
133,2,1529,1537,3,8,0
72,1,1514,1522,4,8,1
88,0,1519,1604,7,85,0
126,0,1622,1514,3,108,0
75,2,1499,1498,4,1,1
89,2,1516,1515,2,1,1
52,1,1532,1517,9,15,0
104,1,1512,1514,2,2,1
59,2,1560,1531,2,29,1
83,2,1513,1507,2,6,1
66,1,1526,1642,2,116,1
24,1,1548,1503,1,45,0
52,1,1512,1751,10,239,1
90,1,1469,1491,4,22,1
59,2,1486,1516,5,30,0
14,1,1651,1481,6,170,0
132,0,1480,1495,5,15,0
126,1,1497,1637,5,140,1
82,1,1510,1725,3,215,1
68,1,1338,1326,7,12,0
126,0,1337,1352,2,15,0
55,2,1329,1253,5,76,1
98,1,1263,1320,5,57,1
95,2,1331,1331,2,0,0
60,1,1345,1208,3,137,0
137,2,1236,1360,3,124,0
43,2,1378,1370,5,8,1
52,1,1379,1424,2,45,1
70,1,1512,1365,3,147,0
48,1,1373,1455,3,82,1
43,1,1382,1441,3,59,1
94,1,1214,1376,5,162,1
86,0,1378,1298,2,80,0
46,1,1393,1367,6,26,0
44,1,1363,1450,3,87,1
56,1,1346,1353,5,7,1
28,1,1364,1349,2,15,0
27,2,1337,1376,5,39,0
61,2,1385,1377,5,8,1
37,2,1371,1193,3,178,1
47,1,1364,1351,4,13,0
96,1,1257,1343,5,86,1
51,2,1334,1265,3,69,1
11,2,1252,1348,3,96,0
40,1,1353,1581,3,228,1
52,1,1362,1388,2,26,1
43,2,1377,1373,5,4,1
50,1,1292,1364,3,72,1
88,1,1210,1358,1,148,1
76,1,1368,1390,4,22,1
58,1,1379,1357,4,22,0
53,2,1345,1377,3,32,0
147,2,1339,1185,3,154,1
21,2,1169,1343,5,174,0
102,1,1511,1328,5,183,0
5,2,1328,1362,2,34,0
38,1,1332,1551,3,219,1
68,1,1349,1321,5,28,0
41,2,1309,1297,4,12,1
29,2,1300,1233,7,67,1
123,2,1428,1150,4,278,1
92,1,1139,1404,4,265,1
116,1,1166,1123,1,43,0
54,1,1137,1359,4,222,1
53,2,1497,1141,3,356,1
41,2,1383,1147,1,236,1
72,1,1148,1880,4,732,1
52,1,1150,1596,2,446,1
15,2,1445,1473,8,28,0
62,1,1454,1488,6,34,1
73,1,1508,1441,4,67,0
62,1,1450,1516,3,66,1
25,2,1506,1460,6,46,1
58,1,1436,1449,4,13,1
72,1,1478,1473,3,5,0
82,1,1487,1559,5,72,1
75,2,1550,1496,4,54,1
97,0,1499,1431,11,68,0
45,2,1486,1526,3,40,0
66,1,1499,1433,3,66,0
44,1,1242,1494,5,252,1
103,2,1490,1247,5,243,1
49,2,1803,1493,6,310,1
170,0,1545,1491,3,54,0
66,1,1489,1604,4,115,1
68,2,1506,1500,8,6,1
97,2,1489,1498,5,9,0
61,2,1471,1487,3,16,0
136,1,1499,1458,4,41,0
128,1,1397,1491,3,94,1
116,1,1504,1450,7,54,0
35,2,1761,1508,5,253,1
55,1,1518,1546,7,28,1
57,2,1536,1528,6,8,1
63,2,1517,1547,6,30,0
56,1,1526,1580,3,54,1
32,1,1675,1510,2,165,0
83,2,1498,1206,4,292,1
69,2,1279,1515,11,236,0
105,2,1502,1603,9,101,0
34,1,1392,1494,5,102,1
27,2,1480,1580,6,100,0
54,1,1596,1466,3,130,0
80,1,1470,1694,2,224,1
84,1,1482,1454,11,28,0
61,2,1480,1430,5,50,1
45,2,1416,1493,6,77,0
139,2,1475,1505,7,30,0
50,1,1432,1493,3,61,1
40,1,1404,1485,5,81,1
105,2,1474,1468,3,6,1
78,1,1485,1484,1,1,0
88,1,1495,1474,5,21,0
27,2,1500,1481,5,19,1
45,2,1470,1479,2,9,0
17,2,1476,1481,5,5,0
45,2,1500,1488,5,12,1
62,1,1493,1477,5,16,0
106,1,1459,1466,9,7,1
72,1,1476,1513,3,37,1
17,2,1303,1491,2,188,0
35,1,1503,1477,3,26,0
41,2,1520,1513,3,7,1
14,0,1511,1576,3,65,0
51,2,1446,1517,5,71,0
97,0,1532,1517,6,15,0
72,1,1528,1517,3,11,0
15,2,1814,1531,6,283,1
19,2,1549,1541,1,8,1
21,2,1531,1526,3,5,1
58,1,1544,1465,3,79,0
25,2,1532,1595,2,63,0
74,1,1306,1500,7,194,1
38,1,1500,1500,4,0,0
35,2,1754,1500,8,254,1
61,2,1640,1500,5,140,1
86,1,1500,1640,5,140,1
20,2,1500,1544,5,44,0
89,2,1544,1500,4,44,1
47,2,1978,1500,9,478,1
63,2,1500,1493,9,7,1
65,2,1281,1196,1,85,1
51,2,1416,1201,2,215,1
22,1,1212,1218,4,6,1
46,1,1224,1222,4,2,0
61,2,1547,1227,2,320,1
36,1,1565,1207,5,358,0
133,1,1208,1871,4,663,1
65,2,1099,1222,3,123,0
59,2,1397,1228,2,169,1
28,2,1219,1162,2,57,1
53,2,1406,1224,9,182,1
55,2,1317,1233,2,84,1
36,1,1281,1220,2,61,0
64,1,1232,1198,7,34,0
55,2,1222,1202,2,20,1
71,2,1650,1661,4,11,0
31,2,1652,1593,7,59,1
111,2,1658,1663,9,5,0
99,2,1730,1672,14,58,1
85,1,1817,1683,4,134,0
35,2,1617,1697,4,80,0
26,2,1688,1612,6,76,1
106,1,1573,1680,1,107,1
17,1,1691,1699,7,8,1
13,2,2549,1425,8,1124,1
55,2,2621,1425,5,1196,1
69,2,1352,1304,5,48,1
57,0,1324,1407,3,83,0
1,2,2621,1324,1,1297,1
86,1,1500,1500,4,0,0
29,2,1815,1727,7,88,1
118,1,1674,1717,5,43,1
50,1,1748,1705,3,43,0
65,2,1645,1601,7,44,1
40,1,1613,1613,2,0,0
50,1,1655,1599,2,56,0
37,2,1488,1616,6,128,0
8,1,1631,1547,2,84,0
36,1,1636,1895,7,259,1
57,2,1643,1693,6,50,0
45,2,1591,1389,5,202,1
39,2,1372,1401,7,29,0
54,1,1411,1407,6,4,0
87,2,1395,1423,3,28,0
46,0,1424,1395,6,29,0
60,1,1435,1404,6,31,0
67,2,1425,1400,6,25,1
82,1,1390,1416,3,26,1
75,2,1427,1426,3,1,1
76,1,1438,1415,4,23,0
64,1,1426,1427,3,1,1
54,1,1256,1421,8,165,1
48,2,1405,1586,5,181,0
52,1,1415,1431,6,16,1
51,2,1487,1424,7,63,1
36,1,1434,1478,5,44,1
93,2,1384,1446,2,62,0
93,2,1555,1454,3,101,1
36,1,1461,1334,4,127,0
65,2,1833,1461,3,372,1
70,1,1461,1833,5,372,1
67,2,1833,1461,3,372,1
100,1,1512,1448,3,64,0
19,2,1434,1526,4,92,0
86,1,1436,1423,3,13,0
68,1,1433,1457,2,24,1
68,1,1444,1443,9,1,0
41,2,1432,1456,6,24,0
56,1,1462,1637,2,175,1
103,2,1833,1452,3,381,1
65,2,1452,1433,4,19,1
47,2,1442,1452,4,10,0
80,1,1428,1431,2,3,1
37,2,1833,1431,3,402,1
74,1,1500,1317,3,183,0
64,1,1317,1500,2,183,1
80,1,1241,1280,3,39,1
188,1,1607,1280,2,327,0
58,2,1280,1607,2,327,0
60,1,1330,1306,7,24,0
71,2,1163,1318,10,155,0
50,2,1163,1617,10,454,0
15,2,1617,1163,4,454,1
7,2,1342,1170,3,172,1
58,1,1177,1316,4,139,1
37,1,1180,1518,15,338,1
22,1,1193,1180,1,13,0
32,1,1180,1193,5,13,1
16,1,1193,1180,6,13,0
22,1,1180,1193,3,13,1
3,2,1183,1191,3,8,0
55,2,1180,1193,3,13,0
25,2,1354,1186,6,168,1
2,2,1286,1198,2,88,1
14,1,1198,1286,6,88,1
13,2,1286,1198,2,88,1
13,2,1198,1500,5,302,0
50,1,1206,1311,10,105,1
22,1,1326,1190,2,136,0
59,2,1808,1758,2,50,1
91,2,1691,1800,3,109,0
53,2,1772,1700,2,72,1
68,1,1710,1738,3,28,1
68,1,1783,1754,8,29,0
33,2,2047,1801,1,246,1
107,2,1993,1830,5,163,1
88,1,1869,1987,8,118,1
43,2,1796,1832,8,36,0
58,1,2010,1653,5,357,0
95,2,1904,1653,2,251,1
92,1,1721,1517,2,204,0
83,2,1880,1546,6,334,1
86,1,1481,1386,4,95,0
70,1,1500,1652,6,152,1
45,2,2621,1626,6,995,1
22,2,1855,1500,6,355,1
19,2,2256,1500,9,756,1
12,2,1500,2037,5,537,0
108,1,1500,2035,10,535,1
48,1,1500,2125,11,625,1
31,2,2473,1500,8,973,1
52,1,1500,1895,3,395,1
43,2,1559,1600,2,41,0
49,2,1600,1559,2,41,1
74,1,1663,1559,5,104,0
116,1,1559,1615,3,56,1
64,1,1473,1559,5,86,1
43,2,1559,1700,5,141,0
81,2,1603,1559,3,44,1
83,2,1559,1738,3,179,0
39,2,1738,1559,11,179,1
100,1,1541,1548,3,7,1
27,2,1548,1659,2,111,0
14,1,1585,1548,11,37,0
206,1,1548,1553,2,5,1
94,1,1548,1620,5,72,1
90,0,1433,1548,3,115,0
69,2,1548,1433,3,115,1
94,1,1611,1548,2,63,0
80,1,1548,1604,5,56,1
42,1,1548,1700,5,152,1
128,1,1590,1548,1,42,0
53,2,1661,1548,3,113,1
23,2,1548,1700,5,152,0
11,2,1523,1130,6,393,1
62,1,1136,1521,3,385,1
43,2,1443,1147,3,296,1
21,2,1324,1133,3,191,1
58,1,1133,1500,3,367,1
56,1,1136,1741,1,605,1
24,1,1136,1564,4,428,1
16,2,1564,1136,4,428,1
40,1,1136,1500,6,364,1
45,2,1429,1148,5,281,1
40,1,1162,1425,3,263,1
49,2,1711,1162,2,549,1
52,1,1162,1699,7,537,1
38,1,1165,1731,5,566,1
55,2,1340,1190,4,150,1
33,2,1575,1190,7,385,1
73,2,1677,1190,2,487,1
12,1,1209,1443,6,234,1
83,2,1432,1209,3,223,1
75,2,1172,1272,3,100,0
23,2,1666,1272,1,394,1
44,1,1290,1584,4,294,1
20,1,1340,1406,1,66,1
19,2,1402,1377,8,25,1
41,2,1315,1498,11,183,0
41,1,1264,1500,1,236,1
31,2,1500,1264,10,236,1
83,2,1410,1408,2,2,1
21,1,1376,1398,5,22,1
53,2,1206,1415,2,209,0
29,2,1404,1435,1,31,0
73,0,1404,1420,2,16,0
57,2,1392,1429,1,37,0
29,2,1624,1397,4,227,1
29,2,1372,1409,2,37,0
20,1,1419,1434,2,15,1
61,2,1410,1355,1,55,1
63,2,1539,1417,4,122,1
19,2,1522,1425,4,97,1
27,1,1438,1367,1,71,0
52,1,1337,1431,2,94,1
42,1,1440,1512,2,72,1
15,2,1486,1450,4,36,1
64,1,1398,1447,2,49,1
31,2,1448,1458,4,10,0
37,2,1447,1442,2,5,1
51,2,1441,1293,1,148,1
64,1,1453,1397,1,56,0
92,0,1477,1452,2,25,0
19,2,1449,1456,2,7,0
28,1,1521,1438,4,83,0
94,2,1437,1446,2,9,0
48,1,1459,1603,2,144,1
40,1,1478,1492,1,14,1
23,2,1513,1488,4,25,1
15,2,1477,1494,1,17,0
63,2,1525,1486,2,39,1
107,2,1473,1585,1,112,0
52,1,1567,1460,4,107,0
29,2,1452,1371,2,81,1
42,1,1463,1440,3,23,0
33,2,1431,1370,2,61,1
46,1,1310,1424,2,114,1
111,2,1412,1478,1,66,0
67,2,1351,1424,2,73,0
51,2,1412,1472,1,60,0
42,1,1421,1468,1,47,1
126,1,1347,1412,4,65,1
55,2,1199,1429,4,230,0
18,1,1527,1882,3,355,1
4,1,1527,1882,1,355,1
54,1,1500,1901,5,401,1
4,1,1533,1897,1,364,1
5,2,1894,1539,1,355,1
26,1,1545,1890,3,345,1
4,1,1552,1887,1,335,1
115,0,1923,1887,3,36,0
127,2,2086,1689,6,397,1
96,1,1606,1680,4,74,1
49,2,1664,1789,11,125,0
31,1,1672,1789,6,117,1
52,1,1216,1670,5,454,1
14,2,1667,1371,2,296,1
54,1,1801,1650,6,151,0
88,1,1658,1802,8,144,1
39,2,1656,1233,4,423,1
83,1,1769,1640,5,129,0
41,2,1622,1865,4,243,0
44,1,1350,1608,6,258,1
51,1,1619,1639,4,20,1
86,1,1625,1822,6,197,1
81,2,1776,1632,4,144,1
71,2,1546,1647,5,101,0
74,1,1648,2159,4,511,1
69,2,1635,1693,7,58,0
44,1,1647,1608,2,39,0
45,2,1673,1657,4,16,1
76,1,1665,1767,6,102,1
44,1,1336,1662,6,326,1
84,1,1669,1810,8,141,1
111,2,1649,1681,2,32,0
83,2,1671,1630,10,41,1
117,0,1398,1679,4,281,0
73,2,1666,1697,6,31,0
74,1,1670,1946,5,276,1
63,2,1667,1352,4,315,1
18,1,1199,1666,2,467,1
29,2,1580,1680,6,100,0
24,1,1689,1735,2,46,1
80,1,1382,1293,4,89,0
77,2,1377,1174,5,203,1
18,1,1149,1372,5,223,1
28,1,1161,1367,3,206,1
11,2,1361,1192,5,169,1
25,2,1349,1247,6,102,1
56,1,1287,1339,4,52,1
42,1,1191,1335,3,144,1
94,1,1349,1251,3,98,0
59,2,1264,1370,4,106,0
95,2,1363,1251,4,112,1
44,1,1249,1355,8,106,1
33,2,1347,1245,5,102,1
45,2,1272,1361,2,89,0
110,1,1288,1352,6,64,1
40,1,1367,1240,5,127,0
207,0,1371,1223,6,148,0
9,2,1364,1219,7,145,1
80,1,1225,1357,5,132,1
76,1,1221,1350,8,129,1
64,2,1335,1234,7,101,1
16,1,1137,1322,6,185,1
45,1,1293,1314,5,21,1
92,1,1327,1255,6,72,0
22,1,1286,1317,3,31,1
72,1,1330,1257,6,73,0
52,1,1296,1321,2,25,1
56,1,1313,1310,5,3,0
88,1,1311,1245,8,66,0
62,1,1273,1301,3,28,1
103,2,1257,1314,2,57,0
49,2,1304,1276,4,28,1
87,2,1295,1238,3,57,1
190,0,1290,1295,1,5,0
30,2,1248,1308,6,60,0
36,1,1332,1285,2,47,0
56,1,1295,1322,4,27,1
103,2,1316,1151,4,165,1
21,2,1296,1328,5,32,0
39,1,1346,1114,2,232,0
36,1,1722,1755,6,33,1
85,2,1734,1891,4,157,0
45,2,1716,1747,7,31,0
81,1,1720,1732,2,12,1
69,2,1706,1949,3,243,0
41,2,1695,1573,7,122,1
78,1,1952,1667,12,285,0
25,2,1639,1911,9,272,0
42,1,1478,1628,3,150,1
150,1,2150,1595,9,555,0
43,2,2166,1590,2,576,1
40,2,1565,1729,1,164,0
37,2,1565,1898,7,333,0
55,2,1950,2212,1,262,0
49,2,1950,1226,2,724,1
78,1,1950,1885,4,65,0
29,0,1950,2204,2,254,0
65,0,1950,1500,2,450,0
66,0,1950,1819,4,131,0
112,0,1950,1477,2,473,0
70,0,1950,1500,3,450,0
50,1,2036,1706,6,330,0
40,1,1795,2036,6,241,1
33,2,2023,1671,2,352,1
30,1,1675,2008,8,333,1
53,2,1990,1678,2,312,1
30,0,1990,1465,5,525,0
11,0,1990,1756,2,234,0
3,0,1990,1779,2,211,0
67,0,1990,1447,2,543,0
41,1,1458,1980,4,522,1
28,2,1967,1500,2,467,1
52,2,1967,1295,3,672,1
30,1,2102,1967,6,135,0
31,2,1330,1500,3,170,0
11,2,2386,1330,5,1056,1
38,2,1487,1340,9,147,1
72,1,1340,2197,6,857,1
23,2,1331,1159,5,172,1
90,1,1334,1798,5,464,1
35,2,2052,1334,9,718,1
23,2,1781,1336,2,445,1
73,2,1458,1347,4,111,1
44,1,1348,2075,7,727,1
17,2,1335,1272,5,63,1
70,1,1339,1705,3,366,1
27,2,1912,1340,10,572,1
32,1,1342,1792,9,450,1
15,2,1516,1500,2,16,1
97,2,1615,1608,1,7,1
86,1,1302,1611,1,309,1
119,2,1599,1580,2,19,1
43,2,1534,1614,4,80,0
77,1,1423,1608,11,185,1
48,2,1586,1947,5,361,0
62,1,1588,1990,5,402,1
129,2,1667,1598,11,69,1
141,2,1759,1605,4,154,1
53,2,2015,1608,8,407,1
88,0,1603,1732,1,129,0
100,1,1604,2215,2,611,1
51,1,1606,2074,2,468,1
39,2,1783,1612,4,171,1
133,2,1993,1615,6,378,1
35,2,1949,1618,6,331,1
112,0,1619,1592,2,27,0
60,1,1624,1839,2,215,1
21,2,1763,1632,4,131,1
41,2,1840,1613,10,227,1
42,1,1623,1655,3,32,1
29,2,1603,1963,3,360,0
37,2,1630,1614,6,16,1
74,1,1750,1598,8,152,0
79,2,1786,1604,6,182,1
148,1,1612,1715,3,103,1
94,1,1644,1595,7,49,0
108,1,1606,1618,5,12,1
146,1,1613,1760,5,147,1
49,2,2031,1615,7,416,1
46,0,1455,1620,6,165,0
117,2,1611,1539,2,72,1
52,1,1614,1924,5,310,1
75,2,1953,1617,7,336,1
52,1,1453,1611,4,158,1
91,2,1599,1603,2,4,0
73,2,1592,1457,5,135,1
32,1,1436,1585,2,149,1
45,2,1574,1489,5,85,1
98,2,1556,1789,2,233,0
32,1,1447,1548,6,101,1
159,2,1364,1565,3,201,0
31,2,1556,1496,2,60,1
61,2,1687,1566,5,121,1
107,2,1548,1605,5,57,0
85,2,1596,1562,4,34,1
130,1,1523,1547,4,24,1
91,2,1533,1456,6,77,1
35,1,1553,1505,8,48,0
124,1,1515,1536,7,21,1
85,1,1554,1568,4,14,1
59,2,1541,1431,6,110,1
48,0,1536,1541,3,5,0
63,2,1655,1556,2,99,1
38,1,1562,1484,5,78,0
32,1,1503,1375,6,128,0
42,1,1500,1466,3,34,0
22,2,1406,1437,6,31,0
103,2,1933,1779,8,154,1
115,2,2188,1933,4,255,1
67,2,1080,1600,4,520,0
85,2,1593,1434,5,159,1
46,1,1434,1586,8,152,1
46,1,1432,1579,4,147,1
54,1,1416,1571,5,155,1
96,1,1415,1564,2,149,1
88,1,1567,1536,8,31,0
54,1,1547,1555,4,8,1
17,2,1545,1465,2,80,1
39,2,1463,1561,7,98,0
57,0,1561,1080,3,481,0
20,0,1500,1561,7,61,0
60,1,1547,1561,11,14,1
73,1,1545,1561,9,16,1
39,2,2206,1640,3,566,1
58,1,1640,1937,20,297,1
34,2,1640,1937,20,297,0
50,1,1640,1937,16,297,1
42,1,1640,1914,4,274,1
55,2,2524,1640,7,884,1
59,2,1500,1418,2,82,1
84,1,1950,1960,3,10,1
29,2,1864,1976,10,112,0
72,2,2065,1976,6,89,1
63,2,1976,1988,10,12,0
141,2,1976,1987,4,11,0
92,1,2035,1961,6,74,0
64,1,1975,1908,8,67,0
90,1,1463,1974,3,511,1
70,1,1997,1480,7,517,0
68,1,1950,1997,2,47,1
63,2,2229,2002,10,227,1
90,1,1216,1555,3,339,1
51,2,2061,1432,6,629,1
70,1,2079,2006,4,73,0
31,2,1664,2107,6,443,0
42,1,2125,2061,10,64,0
90,1,2060,2111,6,51,1
109,2,2105,1867,8,238,1
47,2,2097,1898,6,199,1
64,1,1904,2089,7,185,1
109,2,1153,1120,1,33,1
52,1,1468,1509,3,41,1
75,2,1904,1509,4,395,1
50,1,1509,1904,8,395,1
105,2,1502,1361,4,141,1
69,2,1913,1504,7,409,1
116,1,1509,1738,4,229,1
41,1,1369,1502,6,133,1
44,1,1454,1493,7,39,1
109,2,1427,1493,9,66,0
17,2,1493,1781,5,288,0
47,2,1427,1493,9,66,0
20,1,1493,1781,4,288,1
15,2,1493,1427,11,66,1
45,2,1781,1493,6,288,1
45,2,1781,1493,4,288,1
46,1,1498,1482,11,16,0
77,2,1461,1493,6,32,0
43,2,1638,1500,10,138,1
81,2,1488,1527,5,39,0
139,2,1501,1498,6,3,1
54,1,1547,1486,7,61,0
60,1,1492,1658,4,166,1
36,1,1500,1605,3,105,1
87,2,1753,1723,1,30,1
135,2,1746,1256,1,490,1
76,0,1800,1738,2,62,0
140,0,1686,1747,6,61,0
63,2,1945,1784,2,161,1
46,1,1807,2108,8,301,1
64,1,1548,1770,2,222,1
62,1,1875,1662,5,213,0
59,2,1689,2078,5,389,0
145,2,1634,1841,6,207,0
19,2,1500,1407,5,93,1
60,1,2029,1924,10,105,0
50,1,1931,2070,7,139,1
56,1,1941,1940,8,1,0
38,2,1908,1953,5,45,0
110,1,1832,1946,1,114,1
95,1,1950,1935,3,15,0
37,2,1923,1961,7,38,0
52,1,1886,1914,5,28,1
32,1,1923,1968,8,45,1
96,1,1867,1914,5,47,1
98,1,1925,1909,4,16,0
16,2,1988,1933,4,55,1
29,2,1922,1950,8,28,0
81,2,1913,1878,7,35,1
55,2,1904,1846,4,58,1
67,2,1979,1912,10,67,1
140,0,1908,2059,8,151,0
14,2,1972,1917,4,55,1
28,2,1906,1924,9,18,0
76,1,1857,1897,5,40,1
45,1,1910,1817,8,93,0
15,1,1919,1953,7,34,1
61,2,1910,1870,5,40,1
40,1,1879,1900,11,21,1
67,2,1876,1912,11,36,0
66,1,1882,1902,3,20,1
49,1,1914,1869,4,45,0
114,1,1522,1727,13,205,1
107,2,1708,1528,4,180,1
92,1,1744,1770,7,26,1
63,2,1759,1790,4,31,0
36,1,1750,1741,6,9,0
55,2,1686,1681,6,5,1
85,2,1840,1732,4,108,1
118,1,1713,1637,3,76,0
55,2,1791,1716,3,75,1
135,0,1716,1763,4,47,0
78,1,1804,1931,3,127,1
40,1,1850,1804,5,46,0
114,0,1804,1779,7,25,0
68,1,1701,1500,5,201,0
128,1,1277,1619,1,342,1
125,0,1501,1271,3,230,0
110,1,1279,1385,5,106,1
24,2,1521,1284,8,237,1
53,2,1274,1233,2,41,1
25,2,1262,1281,6,19,0
85,2,1220,1275,5,55,0
119,2,1265,1229,3,36,1
15,2,1217,1278,3,61,0
60,1,1286,1405,4,119,1
36,1,1292,1499,6,207,1
58,1,1465,1274,2,191,0
37,2,1443,1281,1,162,1
100,1,1349,1267,4,82,0
110,1,1962,1973,4,11,1
152,1,1972,2010,8,38,1
33,0,1965,2217,5,252,0
85,2,1953,1982,5,29,0
48,1,1963,1990,5,27,1
118,1,1974,1989,5,15,1
76,1,1985,2009,5,24,1
127,2,2007,1996,11,11,1
42,1,2008,1988,6,20,0
98,2,1500,2008,6,508,0
174,1,2012,2284,12,272,1
64,1,2023,2033,6,10,1
92,1,2036,1991,9,45,0
95,2,2023,2055,5,32,0
28,2,2011,2019,16,8,0
102,0,2009,2069,5,60,0
49,2,1998,2047,12,49,0
70,1,2011,1975,6,36,0
58,1,2014,2350,8,336,1
60,1,2027,2005,5,22,0
66,1,2037,2080,8,43,1
55,2,2022,2127,7,105,0
33,2,2011,1965,3,46,1
61,2,1997,2060,10,63,0
124,1,2011,1962,6,49,0
58,1,2011,2000,9,11,0
134,1,2023,2028,8,5,1
37,2,1726,1565,4,161,1
36,1,1612,1552,3,60,0
33,2,1538,1669,11,131,0
68,1,1531,1674,5,143,1
30,1,1531,1526,4,5,0
31,2,1591,1540,6,51,1
144,1,1633,1526,5,107,0
42,1,1663,1512,3,151,0
81,2,1927,2434,7,507,0
64,1,2619,1927,12,692,0
48,1,1128,1670,2,542,1
79,2,1638,1130,5,508,1
78,1,1132,1619,4,487,1
44,1,1137,1464,2,327,1
47,2,1558,1140,4,418,1
46,1,1143,1612,2,469,1
108,1,1120,1389,3,269,1
48,1,1128,1383,4,255,1
37,2,1468,1133,2,335,1
47,2,1347,1143,4,204,1
39,2,1445,1150,3,295,1
15,2,1116,1338,3,222,0
30,1,1644,1810,4,166,1
52,1,1119,985,4,134,0
70,1,1810,1473,2,337,0
75,2,1436,1484,10,48,0
104,0,1638,1417,2,221,0
129,1,1225,1221,2,4,0
55,2,1227,1253,3,26,0
75,2,1239,1358,7,119,0
18,1,1240,1228,9,12,0
92,1,1235,1352,8,117,1
17,2,1318,1243,3,75,1
82,1,1338,1229,2,109,0
41,2,1158,1243,3,85,0
52,1,1251,1329,5,78,1
60,1,1264,1200,5,64,0
142,1,1278,1252,3,26,0
104,1,1090,1246,3,156,1
88,1,1268,1234,3,34,0
67,2,1221,1280,5,59,0
46,1,1141,1212,2,71,1
44,1,1228,1060,5,168,0
65,2,1274,1238,8,36,1
69,2,1097,1254,3,157,0
65,2,1239,1064,5,175,1
61,2,1045,1256,1,211,0
65,2,1251,1051,3,200,1
200,0,1252,1211,7,41,0
70,1,967,1248,2,281,1
69,2,1238,1225,4,13,1
59,2,1227,1206,1,21,1
135,0,1228,1227,8,1,0
96,1,1233,1215,3,18,0
46,1,1049,1209,4,160,1
30,1,1060,1202,3,142,1
119,2,1189,1237,7,48,0
27,0,907,1196,4,289,0
73,2,1193,912,2,281,1
34,1,918,1188,3,270,1
9,2,1184,924,7,260,1
14,1,931,1180,4,249,1
44,1,1191,1181,4,10,0
25,2,1186,967,8,219,1
113,2,1174,1210,2,36,0
55,1,1304,1158,3,146,0
27,2,1153,963,5,190,1
96,1,1400,1135,5,265,0
62,1,1141,1309,4,168,1
29,2,1224,1149,4,75,1
90,1,1118,1139,2,21,1
50,1,1150,1138,4,12,0
181,0,1148,1240,4,92,0
125,2,1583,1588,4,5,0
151,2,1516,1606,4,90,0
29,1,1630,1522,8,108,0
82,1,1255,1626,3,371,1
51,2,1607,1590,7,17,1
55,2,1588,1630,2,42,0
43,2,1630,1241,4,389,1
87,2,1626,1534,11,92,1
73,2,1483,1661,4,178,0
62,2,1650,1421,6,229,1
54,1,1431,1637,2,206,1
77,2,1479,1500,6,21,0
37,2,1500,1479,10,21,1
8,2,1507,1651,4,144,0
40,1,1902,1759,9,143,0
53,2,1760,1771,1,11,0
49,2,1764,1622,4,142,1
38,1,1500,2051,2,551,1
66,1,1321,2051,3,730,1
77,2,2051,1321,5,730,1
72,1,1321,2051,3,730,1
60,1,1500,2051,3,551,1
58,1,1268,2051,1,783,1
41,2,1417,1407,5,10,1
74,1,1417,1454,5,37,1
39,2,1409,1308,3,101,1
56,1,1316,1400,2,84,1
53,2,1389,1392,7,3,0
96,1,1549,1425,5,124,0
18,1,1833,1380,8,453,0
60,1,1565,1253,4,312,0
13,1,1111,1187,2,76,1
80,1,1264,1367,7,103,1
8,1,1176,1264,4,88,1
61,2,1169,1174,8,5,0
198,1,1246,1340,4,94,1
18,1,1347,1495,5,148,1
18,1,1355,1470,3,115,1
51,2,1359,1366,7,7,0
45,0,1370,1228,7,142,0
36,2,1351,1374,7,23,0
81,1,1141,1369,3,228,1
87,2,1363,1201,5,162,1
68,1,1283,1354,3,71,1
111,2,1347,1186,7,161,1
27,2,1334,1400,3,66,0
19,1,1348,1322,6,26,0
27,1,1329,1466,3,137,1
25,2,1295,1821,4,526,0
102,1,1329,1282,7,47,0
60,1,1285,1598,3,313,1
62,1,1099,1279,3,180,1
130,0,1275,1398,3,123,0
61,2,1350,1285,7,65,1
63,2,1383,1286,7,97,1
50,1,1297,1313,5,16,1
26,1,1273,1286,8,13,1
33,2,1282,1018,5,264,1
17,2,1231,1295,11,64,0
32,1,1306,1298,8,8,0
92,1,1195,1298,1,103,1
47,2,1383,1307,4,76,1
25,2,1296,1284,3,12,1
71,2,1600,1300,6,300,1
57,2,1282,1492,4,210,0
43,0,1386,1279,1,107,0
17,2,1264,1367,6,103,0
68,1,1273,1330,5,57,1
23,2,1192,1279,5,87,0
16,1,1265,1625,8,360,1
11,2,1451,1365,9,86,1
14,2,1331,1365,2,34,0
27,2,1412,1365,2,47,1
16,1,1365,1969,7,604,1
37,2,1969,1365,5,604,1
23,2,1085,1365,8,280,0
32,2,1365,1215,9,150,1
17,2,1427,1365,7,62,1
46,1,1365,1902,6,537,1
55,2,1902,1365,3,537,1
37,2,1365,1817,7,452,0
20,1,1399,1365,5,34,0
24,2,1764,1365,4,399,1
40,1,1365,1881,15,516,1
2,2,1538,1365,2,173,1
68,2,1901,1365,3,536,1
13,2,1500,1365,9,135,1
30,2,1320,1365,1,45,0
29,2,1365,1132,3,233,1
19,2,1365,1315,4,50,1
27,1,1365,1020,3,345,0
99,2,1856,1365,3,491,1
22,2,1365,1856,7,491,0
31,2,1856,1365,11,491,1
76,1,1365,1856,1,491,1
21,2,1856,1365,5,491,1
50,1,1365,1856,1,491,1
42,2,1442,1365,1,77,1
43,2,1365,1966,8,601,0
32,2,1966,1365,2,601,1
34,1,1365,1966,1,601,1
5,2,1500,1472,5,28,1
39,2,1500,1479,5,21,1
33,2,1469,1438,6,31,1
43,2,1382,1484,3,102,0
59,2,1500,1170,3,330,1
82,1,1170,1500,3,330,1
22,1,1229,1160,3,69,0
49,2,1219,1229,5,10,0
73,2,1776,1499,3,277,1
22,1,1771,1764,8,7,0
68,1,1770,1951,5,181,1
25,2,1696,1785,4,89,0
15,1,1554,1780,3,226,1
143,2,1775,1522,3,253,1
79,2,1761,1808,6,47,0
32,1,2005,1761,7,244,0
56,1,1766,2025,5,259,1
120,1,1728,1754,6,26,1
97,2,1735,1973,9,238,0
50,1,1743,1864,5,121,1
63,2,2000,1748,8,252,1
58,1,1899,1741,6,158,0
85,2,1722,1898,4,176,0
111,0,1737,1724,12,13,0
24,1,1750,1722,9,28,0
15,2,1725,1787,10,62,0
84,1,1719,1733,4,14,1
70,2,1719,1727,3,8,0
51,2,1196,1609,1,413,0
92,2,1658,1609,9,49,1
82,1,1609,1657,2,48,1
46,2,1637,1609,3,28,1
72,1,1306,1605,1,299,1
61,2,1605,1603,5,2,1
39,2,1605,1157,4,448,1
39,2,1605,954,3,651,1
25,2,1853,1605,7,248,1
81,2,1600,1362,3,238,1
19,0,1365,1598,2,233,0
35,2,1591,1500,2,91,1
43,2,1585,1500,2,85,1
14,1,913,981,2,68,1
66,1,924,982,2,58,1
121,2,1121,930,2,191,1
47,2,1181,936,2,245,1
83,2,1035,946,2,89,1
40,1,955,1082,2,127,1
90,1,967,999,3,32,1
51,2,1189,973,1,216,1
65,2,964,845,2,119,1
83,2,1251,969,3,282,1
94,1,969,1344,2,375,1
50,1,969,1344,2,375,1
15,2,1344,969,3,375,1
76,1,969,1346,2,377,1
62,1,793,961,2,168,1
93,2,1069,953,1,116,1
123,2,1113,962,1,151,1
64,1,973,1050,2,77,1
78,1,985,1074,2,89,1
47,2,1800,985,5,815,1
52,1,985,1768,2,783,1
45,2,1945,986,2,959,1
42,1,986,1944,2,958,1
45,2,1943,986,2,957,1
77,2,1099,996,1,103,1
81,2,1169,996,4,173,1
74,1,996,1732,1,736,1
82,1,1002,1253,2,251,1
42,1,1002,1731,2,729,1
27,2,1500,1005,5,495,1
44,1,996,991,2,5,0
117,0,1261,966,1,295,0
72,1,972,1229,2,257,1
70,1,979,1164,2,185,1
24,0,1083,975,1,108,0
72,1,970,1090,2,120,1
32,1,1004,952,5,52,0
20,1,961,1109,2,148,1
101,2,1103,972,5,131,1
45,2,943,1255,2,312,0
73,2,1089,954,2,135,1
59,2,1100,965,1,135,1
7,2,1238,1500,3,262,0
7,2,1500,1238,3,262,1
4,1,1500,1238,1,262,0
18,1,1500,1238,3,262,0
23,2,1443,1500,5,57,0
12,1,1500,1626,3,126,1
68,1,1271,1510,2,239,1
77,2,1770,1510,6,260,1
18,2,1510,1770,5,260,0
43,2,1343,1527,3,184,0
36,1,1319,1521,8,202,1
91,2,1512,1448,3,64,1
31,2,1504,1384,2,120,1
13,2,1494,1439,6,55,1
46,1,1418,1485,6,67,1
47,2,1353,1501,6,148,0
50,2,1497,1238,5,259,1
83,2,1416,1511,7,95,0
53,2,1536,1522,6,14,1
47,2,1517,1311,5,206,1
47,2,1484,1530,4,46,0
24,1,1542,1533,5,9,0
71,2,1471,1556,6,85,0
53,2,1555,1393,7,162,1
28,1,1400,1548,10,148,1
44,1,1562,1498,5,64,0
61,2,1559,1211,3,348,1
78,1,1493,1549,1,56,1
34,1,1569,1251,5,318,0
67,2,1450,1585,3,135,0
14,1,1605,1342,5,263,0
46,1,1622,1454,7,168,0
46,1,1550,1612,4,62,1
97,2,1609,1256,5,353,1
148,1,1260,1606,4,346,1
59,2,1590,1395,11,195,1
25,0,1525,1593,6,68,0
56,1,1611,1401,5,210,0
45,2,1605,1388,7,217,1
50,1,1472,1598,7,126,1
127,0,1603,1445,6,158,0
70,1,1370,1597,6,227,1
47,2,1500,1597,6,97,0
74,1,1370,1592,6,222,1
40,2,1592,1456,3,136,1
67,2,1592,1500,4,92,1
89,2,1592,1436,5,156,1
37,2,1801,1886,1,85,0
83,2,2124,1891,3,233,1
39,0,1894,1781,10,113,0
43,2,1892,1470,8,422,1
55,2,1886,1706,11,180,1
67,2,1914,1897,8,17,1
80,1,1845,1887,1,42,1
47,2,1755,1903,4,148,0
113,1,1550,1517,7,33,0
108,1,1593,1538,2,55,0
43,2,1523,1668,9,145,0
13,2,1556,1533,2,23,1
138,1,1536,1836,9,300,1
47,2,1525,1541,6,16,0
16,2,1511,1536,10,25,0
19,2,1553,1547,4,6,1
49,2,1534,1602,9,68,0
33,1,1545,1541,6,4,0
63,2,1616,1554,9,62,1
41,2,1542,1583,7,41,0
55,2,1531,1538,6,7,0
15,2,1554,1541,10,13,1
42,2,1711,1555,3,156,1
24,1,1561,1740,11,179,1
54,1,1513,1552,1,39,1
20,2,1575,1561,10,14,1
72,1,1570,1633,5,63,1
51,2,1635,1579,1,56,1
48,1,1629,1567,9,62,0
47,2,1770,1572,10,198,1
44,1,1320,1559,4,239,1
31,1,1567,1648,5,81,1
91,2,1713,1573,4,140,1
28,1,1580,1706,9,126,1
23,2,1695,1588,7,107,1
37,2,1662,1596,15,66,1
20,1,1604,1705,7,101,1
18,2,1657,1613,10,44,1
17,2,1700,1621,8,79,1
33,2,1691,1630,8,61,1
42,1,1638,1719,4,81,1
35,2,1694,1647,13,47,1
32,2,1634,1658,8,24,0
61,2,1648,1638,9,10,1
60,1,1659,1636,5,23,0
36,1,1668,1717,8,49,1
180,1,1621,1659,6,38,1
68,2,1756,1667,6,89,1
26,2,1761,1675,19,86,1
74,1,1682,1792,12,110,1
124,1,1694,1636,3,58,0
90,1,1685,1684,8,1,0
9,2,1668,1695,5,27,0
64,1,1595,1687,3,92,1
1,2,2403,1746,1,657,1
5,2,2454,1746,3,708,1
59,2,1171,1432,7,261,0
113,2,1403,1364,3,39,1
62,1,1446,1359,3,87,0
58,1,1369,1413,3,44,1
12,1,1468,1354,3,114,0
84,1,1331,1434,3,103,1
41,2,1215,1432,3,217,0
43,2,1426,1265,1,161,1
17,2,1425,1351,2,74,1
37,2,1713,1500,2,213,1
103,0,2283,2358,4,75,0
109,0,2214,2286,2,72,0
92,1,2232,2272,8,40,1
77,2,2264,2082,15,182,1
76,1,1826,2262,5,436,1
22,2,2255,2008,6,247,1
62,1,2007,2249,14,242,1
70,1,1801,2246,8,445,1
63,0,2239,2401,5,162,0
58,1,1471,2239,12,768,1
95,1,2094,2228,6,134,1
109,0,2229,2220,17,9,0
42,1,2162,2214,8,52,1
102,1,2236,2148,2,88,0
97,2,2268,2254,17,14,1
56,1,1144,1500,4,356,1
20,0,1500,1264,9,236,0
43,2,1247,1500,2,253,0
62,1,1247,1500,2,253,1
77,2,1500,1234,5,266,1
31,0,1234,1500,1,266,0
3,2,1500,1193,3,307,1
89,2,1859,1734,4,125,1
63,2,1699,1752,6,53,0
69,2,1655,1516,2,139,1
52,1,1671,1503,2,168,0
63,2,1485,1688,3,203,0
99,2,1683,1491,4,192,1
42,1,1648,1672,3,24,1
64,1,1551,1665,3,114,1
54,1,1484,1659,2,175,1
50,1,1545,1651,3,106,1
44,1,1665,1563,8,102,0
43,2,1656,1571,8,85,1
82,0,1569,1659,4,90,0
16,1,1674,1554,4,120,0
134,1,1529,1667,2,138,1
27,2,1659,1547,6,112,1
117,2,1598,1673,1,75,0
43,2,1666,1526,6,140,1
68,1,1679,1622,3,57,0
63,2,1569,1694,3,125,0
58,1,1606,1686,4,80,1
52,1,1469,1680,2,211,1
36,1,1460,1675,4,215,1
78,1,1449,1670,1,221,1
54,1,1687,1513,6,174,0
54,1,1541,1680,5,139,1
59,2,1674,1488,6,186,1
63,2,1491,1691,4,200,0
54,1,1466,1686,3,220,1
32,1,1703,1488,4,215,0
52,1,1493,1698,4,205,1
45,1,1546,1691,4,145,1
31,2,1684,1553,6,131,1
68,1,1531,1677,8,146,1
50,1,1508,1670,1,162,1
83,2,1665,1475,4,190,1
61,2,1519,1681,1,162,0
78,1,1481,1675,1,194,1
77,2,1669,1487,2,182,1
84,1,1468,1664,2,196,1
40,1,1465,1658,6,193,1
51,2,1634,1462,5,172,1
106,1,1466,1741,7,275,1
42,1,1456,1442,6,14,0
25,2,1453,1258,7,195,1
94,2,1470,1464,6,6,1
40,1,1449,1453,10,4,1
53,2,1441,1459,5,18,0
77,2,1334,1456,10,122,0
138,1,1444,1445,3,1,1
78,1,1458,1404,9,54,0
72,1,1465,1446,3,19,0
108,2,1432,1521,6,89,0
27,2,1435,1456,7,21,0
71,2,1445,1446,2,1,0
94,1,1614,1428,6,186,0
45,2,1473,1448,3,25,1
58,1,1463,1436,1,27,0
76,1,1448,1439,3,9,0
127,2,1434,1515,5,81,0
86,1,1442,1563,3,121,1
43,1,1426,1430,5,4,1
40,1,1414,1419,5,5,1
20,1,1512,1404,8,108,0
88,1,1403,1419,8,16,1
73,0,1406,1326,4,80,0
148,0,1412,1564,6,152,0
46,1,1146,1408,3,262,1
49,2,1405,1127,4,278,1
52,1,1413,1528,6,115,1
64,1,1424,1443,4,19,1
124,1,1264,1420,3,156,1
65,2,1190,1470,3,280,0
41,2,1667,1192,6,475,1
30,1,1069,1182,5,113,1
55,2,1167,1176,4,9,0
33,2,1561,1170,3,391,1
39,2,1356,1178,8,178,1
27,2,1627,1180,4,447,1
61,2,1506,1184,4,322,1
39,2,1633,1187,3,446,1
45,2,1344,1195,3,149,1
71,2,1610,1198,4,412,1
71,2,1658,1200,5,458,1
51,2,1389,1208,3,181,1
37,2,1711,1209,4,502,1
60,1,1215,1485,3,270,1
22,0,1493,1205,3,288,0
31,2,1640,1207,7,433,1
26,1,1209,1639,3,430,1
41,2,1611,1213,4,398,1
72,1,1544,1188,4,356,0
32,1,1180,1674,6,494,1
57,2,1379,1187,3,192,1
52,1,1194,1373,5,179,1
33,2,1438,1200,4,238,1
41,2,1814,1201,3,613,1
48,2,1177,1504,6,327,0
39,2,1621,1179,5,442,1
46,1,1184,1440,6,256,1
51,2,1364,1192,2,172,1
29,2,1492,1196,7,296,1
69,2,1621,1198,3,423,1
17,2,1379,1206,1,173,1
84,1,1207,1724,3,517,1
49,2,1185,1438,5,253,0
47,2,1594,1188,5,406,1
53,2,1523,1191,2,332,1
76,1,1195,1516,3,321,1
48,1,1202,1382,6,180,1
57,2,1452,1251,2,201,1
19,2,1411,1465,4,54,0
76,1,1313,1458,2,145,1
32,1,1474,1323,3,151,0
67,2,1330,1490,4,160,0
109,2,1425,1503,3,78,0
71,2,1492,1497,3,5,0
72,1,1407,1483,2,76,1
41,2,1477,1314,3,163,1
65,2,1461,1489,5,28,0
99,0,1491,1451,3,40,0
15,2,1242,1491,7,249,0
39,2,1485,1281,4,204,1
31,2,1373,1500,3,127,0
36,2,1493,1355,3,138,1
63,2,1486,1342,3,144,1
44,1,1538,1472,2,66,0
17,2,1423,1484,2,61,0
20,1,1496,1459,3,37,0
76,1,1491,1485,4,6,0
133,2,1478,1305,3,173,1
21,2,1470,1353,3,117,1
115,2,1562,1479,5,83,1
37,2,1587,1500,5,87,1
100,1,1587,1500,4,87,0
61,2,1587,1500,4,87,1
3,2,1500,1587,2,87,0
117,2,1500,1587,8,87,0
73,2,1500,1587,5,87,0
71,0,1584,1500,3,84,0
97,2,1584,1500,5,84,1
42,1,1500,1584,2,84,1
73,2,1780,1589,11,191,1
44,1,1554,1589,8,35,1
16,1,1589,1500,10,89,0
17,2,1589,1255,5,334,1
40,1,1589,1141,4,448,0
57,2,1589,1489,11,100,1
15,2,1589,1337,5,252,1
91,2,1589,1500,4,89,1
66,1,1589,1348,6,241,0
49,2,1500,1589,2,89,0
53,2,1500,1589,3,89,0
32,1,1372,1589,9,217,1
61,2,1589,1500,5,89,1
62,0,1437,1589,5,152,0
161,2,1589,1500,3,89,1
39,2,1589,1500,8,89,1
52,1,1500,1589,3,89,1
39,2,1580,1519,3,61,1
43,2,1570,1251,4,319,1
46,1,1288,1565,1,277,1
15,2,1560,1349,2,211,1
62,1,1500,1554,1,54,1
105,2,1500,1554,6,54,0
19,2,1554,1500,5,54,1
68,1,1399,1554,6,155,1
38,1,1362,1554,9,192,1
31,2,1145,1554,5,409,0
15,2,1554,1347,5,207,1
41,2,1554,1236,4,318,1
61,1,1564,1577,6,13,1
110,1,1364,1564,4,200,1
53,2,1564,1500,3,64,1
56,1,1500,1564,3,64,1
65,2,1564,1500,3,64,1
26,2,1500,1564,3,64,0
51,2,1876,1921,13,45,0
103,2,1865,1841,4,24,1
48,1,1536,1862,7,326,1
96,1,1878,1724,7,154,0
120,1,1844,1868,3,24,1
96,1,1732,1855,1,123,1
64,1,1867,1878,4,11,1
66,1,1730,1859,5,129,1
80,1,1948,1844,4,104,0
41,2,1918,1858,11,60,1
57,2,1844,1907,9,63,0
109,0,1905,1842,5,63,0
36,2,1834,1732,8,102,1
79,2,1823,1770,14,53,1
79,2,1813,1835,7,22,0
58,1,1856,1509,7,347,0
65,2,1453,1878,5,425,0
48,1,1888,1957,9,69,1
75,2,1878,1816,6,62,1
41,2,1804,1893,7,89,0
69,2,1881,1873,10,8,1
82,1,1705,1874,2,169,1
33,2,1469,1896,3,427,0
74,1,1910,1863,9,47,0
74,1,1493,1908,8,415,1
88,1,1931,1384,7,547,0
40,1,1941,1985,8,44,1
112,1,1998,1927,8,71,0
81,2,1923,1625,5,298,1
51,2,2003,1932,3,71,1
37,2,1930,1552,2,378,1
39,1,1914,1918,5,4,1
79,2,1807,1934,2,127,0
80,1,1947,1909,13,38,0
95,2,1945,1534,2,411,1
64,1,1691,1940,2,249,1
47,1,1759,1934,13,175,1
54,1,1947,1914,10,33,0
45,2,1953,1959,5,6,0
58,1,1820,1951,6,131,1
39,2,1943,1815,2,128,1
48,2,1890,1957,8,67,0
63,2,1954,1613,5,341,1
63,2,1947,1784,2,163,1
59,2,1946,1469,2,477,1
122,0,2019,1943,2,76,0
28,1,1949,2156,10,207,1
137,2,1502,1517,7,15,0
35,2,1720,1507,4,213,1
34,2,1504,1519,3,15,0
74,1,1536,1507,4,29,0
46,1,1509,1913,4,404,1
69,2,1495,1577,3,82,0
91,2,1366,1511,3,145,0
49,2,1505,1319,7,186,1
40,2,1952,1506,4,446,1
18,1,1508,1951,3,443,1
25,2,1572,1517,5,55,1
84,1,1527,1554,3,27,1
54,1,1632,1513,7,119,0
32,1,1517,1762,3,245,1
127,2,1507,1482,6,25,1
65,2,1382,1522,3,140,0
31,2,1522,1542,5,20,0
39,2,1453,1536,3,83,0
15,2,1531,1291,6,240,1
31,2,1516,1543,4,27,0
55,2,1543,1267,2,276,1
39,2,1543,1500,4,43,1
63,2,1404,1558,2,154,0
68,1,1568,1614,3,46,1
27,2,1795,1573,9,222,1
79,2,1567,1389,3,178,1
65,2,1624,1576,4,48,1
76,1,1557,1566,4,9,1
20,2,1559,1500,3,59,1
41,2,1532,1571,9,39,0
50,1,1582,1586,3,4,1
101,2,1575,1593,4,18,0
22,1,1607,1519,7,88,0
161,2,1596,1589,6,7,1
136,1,1701,1582,3,119,0
80,1,1590,1651,8,61,1
56,1,1506,1582,4,76,1
106,1,1653,1568,3,85,0
5,2,1315,1198,4,117,1
14,1,1227,1276,2,49,1
68,1,1334,1284,3,50,0
71,2,1297,1335,2,38,0
58,1,1503,1495,7,8,0
80,0,1149,1503,8,354,0
106,1,1149,1503,6,354,1
57,2,1493,1473,3,20,1
33,2,1461,1505,7,44,0
39,2,1423,1505,5,82,0
92,1,1251,1331,6,80,1
21,2,1309,1269,6,40,1
55,2,1290,1186,4,104,1
18,2,1459,1307,4,152,1
40,1,1335,1360,7,25,1
43,1,1286,1304,7,18,1
14,1,1284,1301,5,17,1
30,1,1368,1184,5,184,0
54,1,1415,1438,4,23,1
63,2,1486,1470,7,16,1
44,1,1536,1549,5,13,1
56,1,1418,1461,3,43,1
86,1,1512,1726,4,214,1
27,2,1765,1590,6,175,1
50,1,1271,1500,4,229,1
38,1,1063,1186,3,123,1
34,1,1500,1265,1,235,0
55,2,1495,1460,3,35,1
71,2,1461,1508,5,47,0
109,1,1525,1494,5,31,0
84,1,1530,1561,3,31,1
76,1,1575,1516,10,59,0
65,2,1514,1108,5,406,1
27,2,1602,1523,5,79,1
13,1,1538,1452,5,86,0
66,1,1541,1900,7,359,1
79,2,1708,1548,2,160,1
76,1,1270,1544,5,274,1
82,1,1762,1834,4,72,1
65,2,1740,1729,5,11,1
62,1,1758,1851,4,93,1
58,1,1916,1749,3,167,0
49,2,1730,1592,6,138,1
43,2,1713,1527,2,186,1
44,1,1987,1653,3,334,0
91,2,2039,1660,13,379,1
57,2,1598,1891,4,293,0
127,2,1506,2117,6,611,0
70,1,1783,1432,10,351,0
47,2,1361,1629,6,268,0
59,2,1682,1417,3,265,1
19,1,1389,1682,5,293,1
45,2,1682,1500,3,182,1
42,1,1500,1682,3,182,1
19,2,1682,1500,3,182,1
60,1,1130,1383,6,253,1
50,1,1136,1383,1,247,1
37,2,1383,1136,6,247,1
76,1,984,1378,5,394,1
46,1,1378,1377,4,1,0
11,2,1372,1003,4,369,1
77,2,1364,1065,3,299,1
20,1,1196,1348,5,152,1
37,2,1336,1088,3,248,1
89,2,1310,1273,5,37,1
17,0,1382,1304,3,78,0
30,2,1285,1116,4,169,1
77,2,1271,1328,8,57,0
124,1,1930,1897,10,33,0
43,2,2012,1904,11,108,1
37,2,1891,1977,8,86,0
53,2,1882,1828,8,54,1
80,1,1822,1873,3,51,1
91,2,1890,1884,9,6,1
109,0,1884,1873,9,11,0
51,2,1861,1896,17,35,0
43,2,1883,1942,6,59,0
77,2,1128,795,2,333,1
130,1,1128,2177,2,1049,1
85,2,1114,1189,1,75,0
51,0,1191,1111,1,80,0
53,2,1111,921,4,190,1
36,1,897,1111,2,214,1
26,2,1111,897,1,214,1
52,2,1099,1124,2,25,0
139,2,1115,1013,1,102,1
72,1,1099,1115,2,16,1
142,1,1099,1115,2,16,1
60,1,1136,843,2,293,0
23,2,798,1157,2,359,0
9,2,2419,1157,5,1262,1
43,2,1151,964,1,187,1
141,2,1630,1537,3,93,1
153,0,1588,1631,3,43,0
76,1,1601,1621,3,20,1
73,2,1610,1611,3,1,0
24,1,1550,1600,4,50,1
81,1,1677,1587,7,90,0
57,2,1573,1653,2,80,0
35,2,1561,1587,2,26,0
39,2,1638,1570,7,68,1
31,2,1559,1548,7,11,1
47,2,1699,1566,2,133,1
137,2,1557,1494,6,63,1
58,1,1532,1546,5,14,1
112,1,1616,1532,5,84,0
48,1,1543,1550,7,7,1
59,2,1533,1555,7,22,0
109,2,1727,1562,2,165,1
69,2,1552,1491,5,61,1
55,2,1814,1557,2,257,1
52,1,1561,1852,8,291,1
134,1,1271,1557,4,286,1
109,2,1551,1356,4,195,1
90,2,1604,1561,7,43,1
63,2,1544,1738,4,194,0
62,1,1568,1578,4,10,1
38,1,1360,1562,7,202,1
31,2,1552,1503,7,49,1
166,1,1562,1539,5,23,0
114,1,1483,1737,4,254,1
66,1,1488,1727,7,239,1
43,2,1880,1490,9,390,1
103,2,1898,1493,5,405,1
54,1,1499,1667,7,168,1
140,1,1579,1484,4,95,0
73,0,1485,1465,4,20,0
49,2,1463,1201,4,262,1
25,2,1785,1466,5,319,1
34,1,1470,1742,3,272,1
45,2,1786,1474,8,312,1
44,1,1475,2012,8,537,1
123,2,1864,1477,2,387,1
43,2,1826,1480,3,346,1
39,2,1469,1469,4,0,0
40,1,1302,1462,7,160,1
58,1,1469,1609,6,140,1
66,1,1566,1455,2,111,0
22,1,1462,1610,7,148,1
54,1,1480,1231,2,249,0
52,1,1500,1698,4,198,1
61,2,1720,1783,4,63,0
31,2,1855,1792,3,63,1
183,2,1847,1801,3,46,1
159,2,1792,1743,4,49,1
116,1,1798,1988,6,190,1
53,2,1788,1756,6,32,1
114,0,1755,1789,3,34,0
96,1,1696,1789,6,93,1
141,1,1799,1832,3,33,1
151,2,1799,1500,4,299,1
98,1,1562,1799,3,237,1
105,2,1799,1500,8,299,1
131,2,1851,1808,1,43,1
77,1,1749,1799,11,50,1
105,2,1790,1734,6,56,1
55,2,1340,1790,5,450,0
72,1,1801,1794,4,7,0
87,2,1801,1377,2,424,1
62,1,1729,1801,9,72,1
53,2,1801,1729,7,72,1
75,2,1500,1801,6,301,0
26,1,1801,1500,1,301,0
142,1,1808,1914,5,106,1
49,2,1755,1821,9,66,0
87,2,1716,1835,3,119,0
88,0,1835,1632,6,203,0
107,2,1835,1632,6,203,1
132,1,1847,1809,7,38,0
38,1,1860,1770,4,90,0
110,1,1784,1851,4,67,1
81,2,1841,1832,12,9,1
129,2,1850,1851,7,1,0
126,1,1851,1703,6,148,0
123,2,1851,1703,7,148,1
222,0,1851,1853,4,2,0
31,2,1839,1864,5,25,0
101,2,1808,1890,4,82,0
74,1,1643,1878,3,235,1
97,2,1876,2621,7,745,0
88,1,1886,1880,8,6,0
114,0,1875,1922,2,47,0
27,1,1828,1890,10,62,1
31,2,2008,1840,3,168,1
52,1,1861,1882,15,21,1
72,1,1856,1836,4,20,0
66,2,1865,1860,3,5,1
68,1,1814,1836,6,22,1
70,1,1869,1802,3,67,0
27,2,1865,1509,6,356,1
50,1,1542,1842,3,300,1
40,1,1594,1529,8,65,0
51,2,1428,1544,3,116,0
118,1,1552,1648,9,96,1
89,2,1574,1562,5,12,1
67,0,1590,1561,3,29,0
31,2,1558,1235,6,323,1
101,2,1547,1567,5,20,0
37,2,1517,1559,9,42,0
80,1,1429,1552,3,123,1
10,1,1675,1500,1,175,0
30,2,1604,1700,9,96,0
94,1,1444,1696,3,252,1
78,1,1246,1694,6,448,1
57,2,1684,1658,5,26,1
60,1,1689,1893,9,204,1
41,2,1678,1698,3,20,0
81,2,1671,1553,6,118,1
45,2,1659,1684,10,25,0
27,2,1695,1669,3,26,1
47,1,1680,1684,5,4,1
16,1,1696,1668,3,28,0
48,2,1692,1679,3,13,1
52,1,1702,1667,5,35,0
63,2,1683,1677,11,6,1
132,1,1688,1703,11,15,1
53,2,1689,1699,9,10,0
77,2,1689,1655,6,34,1
54,2,1798,1697,1,101,1
56,1,1707,1756,11,49,1
60,1,1715,1804,8,89,1
53,1,1727,1702,11,25,0
76,1,1748,1715,3,33,0
51,2,2040,1718,3,322,1
86,2,1713,1493,11,220,1
109,2,1697,1725,5,28,0
84,1,1777,1712,8,65,0
43,1,1724,1697,5,27,0
72,1,1735,1747,6,12,1
53,2,1757,1746,6,11,1
93,2,1751,1753,9,2,0
34,1,1762,1847,7,85,1
54,1,1901,1746,7,155,0
90,1,1385,1756,3,371,1
53,2,1754,1387,3,367,1
72,1,1765,1774,17,9,1
37,2,1308,1765,3,457,0
57,2,1788,1891,7,103,0
36,1,1788,1563,5,225,0
65,2,1878,1788,5,90,1
58,0,1352,1788,5,436,0
49,2,1788,1698,10,90,1
50,2,2203,1788,5,415,1
49,2,1558,1289,4,269,1
55,2,1443,1296,4,147,1
18,1,1275,1281,5,6,1
92,1,1291,1333,6,42,1
109,2,1268,1303,4,35,0
55,2,1291,1326,2,35,0
57,2,1698,1293,6,405,1
18,1,1297,1591,5,294,1
29,0,1300,1279,4,21,0
41,2,1265,1373,2,108,0
19,2,1348,1274,1,74,1
75,2,1264,1216,2,48,1
55,2,1465,1270,5,195,1
36,1,1343,1256,3,87,0
73,2,1286,1276,6,10,1
19,2,1564,1621,5,57,0
26,1,1580,1390,2,190,0
42,1,1569,1570,2,1,1
55,2,1560,1518,15,42,1
78,1,1567,1702,5,135,1
104,1,1500,1560,4,60,1
135,2,2029,2103,15,74,0
55,2,2094,2039,4,55,1
44,1,1462,1473,8,11,1
62,1,1533,1430,5,103,0
28,2,1364,1463,4,99,0
41,1,1491,1491,3,0,0
18,2,1648,1509,7,139,1
80,1,1291,1494,8,203,1
63,2,1474,1337,3,137,1
51,2,1453,1306,7,147,1
39,1,1674,1557,6,117,0
36,1,1701,1618,5,83,0
37,2,1795,1709,1,86,1
39,2,1692,1889,7,197,0
105,2,1663,1812,9,149,0
20,2,1652,1635,8,17,1
69,2,1774,1660,5,114,1
41,2,1591,1674,3,83,0
57,2,1595,1689,4,94,0
91,2,1677,1683,8,6,0
87,2,1663,1711,6,48,0
68,1,1674,1500,5,174,0
44,1,1635,1663,4,28,1
81,2,1666,1605,4,61,1
111,2,1613,1680,11,67,0
90,1,1535,1673,3,138,1
59,2,1673,1607,4,66,1
53,2,1620,1687,3,67,0
62,1,1698,1739,9,41,1
111,2,1615,1714,5,99,0
72,1,1725,1786,4,61,1
65,1,1731,1711,11,20,0
35,2,1699,1671,8,28,1
53,2,1679,1714,3,35,0
47,2,1447,1736,7,289,0
51,1,1750,1739,2,11,0
19,2,1748,1283,3,465,1
57,1,1752,2079,4,327,1
70,1,1763,1738,4,25,0
101,2,1598,1757,4,159,0
57,2,1783,1530,7,253,1
76,1,1536,1726,6,190,1
62,1,1669,1520,2,149,0
56,1,1522,1941,2,419,1
107,2,1681,1528,5,153,1
21,1,1536,1642,2,106,1
33,2,1743,1542,3,201,1
69,2,1527,1648,6,121,0
57,2,1652,1534,6,118,1
37,2,1681,1541,5,140,1
47,2,1626,1550,2,76,1
77,1,1558,1652,5,94,1
60,1,1567,1646,4,79,1
60,1,1576,1656,6,80,1
85,2,1558,1588,3,30,0
125,2,1576,1596,5,20,0
61,2,1833,1581,4,252,1
209,2,1859,1585,5,274,1
89,2,1680,1593,5,87,1
104,0,1588,1756,3,168,0
49,2,1575,1643,7,68,0
116,1,1583,1699,2,116,1
77,2,1797,1588,5,209,1
78,1,1731,1572,3,159,0
43,2,1565,1584,3,19,0
34,1,1698,1568,3,130,0
70,1,1572,1828,3,256,1
23,2,1645,1568,5,77,1
132,2,1623,1578,4,45,1
121,2,1657,1587,4,70,1
50,2,1934,1590,4,344,1
51,2,1657,1600,4,57,1
45,2,1668,1610,4,58,1
90,1,1616,1776,7,160,1
45,2,1607,1551,2,56,1
26,1,1623,1594,5,29,0
19,2,2189,1595,4,594,1
70,2,1581,1649,6,68,0
27,2,1710,1589,3,121,1
99,2,1853,1593,5,260,1
52,1,1595,2030,2,435,1
72,1,1589,1728,2,139,1
61,2,1956,1591,4,365,1
33,2,1832,1583,7,249,1
85,2,1737,1590,3,147,1
45,2,1712,1598,3,114,1
50,1,1211,1500,6,289,1
43,2,1834,1218,4,616,1
43,2,1742,1218,3,524,1
17,2,1742,1218,2,524,1
113,2,1500,1261,2,239,1
18,1,1317,1538,2,221,1
46,1,1317,1500,3,183,1
23,2,1500,1317,5,183,1
39,2,1940,1327,3,613,1
63,2,1504,1500,2,4,1
102,1,1724,1847,3,123,1
24,2,1800,1733,5,67,1
80,1,1741,1880,8,139,1
25,2,1874,1748,3,126,1
12,1,1758,1815,6,57,1
56,1,1842,1743,11,99,0
53,0,1741,1804,8,63,0
63,2,1727,1800,6,73,0
75,2,1847,1735,5,112,1
33,2,1867,1743,4,124,1
42,1,1753,1811,6,58,1
64,1,1809,1739,3,70,0
17,1,1811,1723,5,88,0
34,1,1733,1802,5,69,1
41,2,1826,1743,4,83,1
37,2,1726,1856,4,130,0
73,2,1710,1815,4,105,0
110,1,1719,1817,6,98,1
41,2,1809,1729,13,80,1
62,1,1884,1710,2,174,0
44,1,1797,1693,11,104,0
57,0,1689,1801,4,112,0
49,2,1668,1891,4,223,0
55,2,1804,1677,2,127,1
83,2,1805,1686,5,119,1
52,1,1696,1812,10,116,1
26,1,1703,1880,5,177,1
82,1,1890,1681,12,209,0
80,1,1690,1830,4,140,1
37,2,1823,1700,10,123,1
18,2,1679,1838,4,159,0
47,2,1908,1697,2,211,1
42,1,1704,1903,6,199,1
71,2,1897,1713,3,184,1
71,2,1880,1722,4,158,1
67,2,1888,1732,4,156,1
75,2,1850,1744,5,106,1
43,2,1792,1760,4,32,1
41,1,1775,1816,5,41,1
69,2,1806,1793,2,13,1
24,2,1772,1817,5,45,0
41,1,1772,1919,6,147,1
73,2,1877,1787,6,90,1
31,2,1886,1803,6,83,1
37,2,1739,1830,6,91,0
84,1,1852,1872,4,20,1
57,2,1861,1877,3,16,0
29,2,1850,1872,8,22,0
56,1,1881,1830,11,51,0
36,1,1352,1610,6,258,1
87,2,1605,1296,8,309,1
114,1,1066,1602,3,536,1
53,2,1477,1602,2,125,0
41,2,1602,1477,6,125,1
62,1,1708,2024,5,316,1
63,2,2024,1708,3,316,1
54,1,1708,2024,11,316,1
38,1,1708,2024,6,316,1
115,0,1458,1708,5,250,0
68,1,1708,1844,4,136,1
21,1,1708,1500,7,208,0
64,2,1545,1708,2,163,0
68,1,1708,1708,2,0,0
50,1,1500,1708,11,208,1
61,2,1708,1500,4,208,1
8,1,1478,1708,2,230,1
45,2,1708,1577,7,131,1
86,1,1701,1708,4,7,1
84,1,1520,1708,4,188,1
37,2,1708,1410,3,298,1
119,2,1708,1410,6,298,1
45,2,1332,1708,3,376,0
46,2,2180,1708,3,472,1
84,1,1708,2180,5,472,1
45,0,2180,1708,9,472,0
52,1,1323,1708,2,385,1
25,1,1708,1540,2,168,0
91,2,1954,1708,3,246,1
3,2,1708,1215,2,493,1
45,2,1708,1668,5,40,1
64,1,1470,1708,4,238,1
54,1,1708,1579,3,129,0
101,2,1708,1638,2,70,1
147,2,1708,1592,4,116,1
65,2,1371,1486,4,115,0
90,1,1479,1475,4,4,0
61,2,1339,1490,4,151,0
130,1,1506,1321,3,185,0
44,1,1454,1497,4,43,1
39,2,1488,1422,3,66,1
43,2,1476,1506,5,30,0
62,1,1397,1468,5,71,1
69,2,1461,1338,5,123,1
56,1,1364,1453,3,89,1
92,1,1456,1444,7,12,0
68,1,1400,1446,3,46,1
65,2,1435,1486,5,51,0
72,1,1354,1427,3,73,1
51,2,1418,1361,4,57,1
90,1,1409,1407,4,2,0
129,2,1399,1319,5,80,1
48,1,1386,1388,4,2,1
54,1,1398,1436,2,38,1
56,1,1409,1268,5,141,0
118,1,1500,1400,4,100,0
107,2,1473,1409,5,64,1
46,1,1361,1399,3,38,1
19,2,1389,1370,3,19,1
42,1,1381,1379,11,2,0
39,2,1368,1382,2,14,0
57,2,1359,1339,4,20,1
43,2,1348,1360,3,12,0
79,2,1349,1359,3,10,0
103,2,1415,1379,5,36,1
104,1,1389,1405,5,16,1
78,1,1397,1509,5,112,1
67,2,1392,1395,4,3,0
66,1,1407,1373,3,34,0
113,2,1359,1420,4,61,0
13,2,1410,1390,3,20,1
18,1,1429,1399,4,30,0
38,1,1374,1391,1,17,1
68,1,1403,1363,3,40,0
37,2,1350,1416,4,66,0
38,1,1355,1406,4,51,1
74,1,1782,1710,5,72,0
76,1,1734,1697,7,37,0
27,1,1707,1775,4,68,1
55,2,1978,1711,8,267,1
48,2,1704,1549,4,155,1
76,1,1710,1692,7,18,0
168,1,1705,1679,5,26,0
46,1,1712,1867,4,155,1
114,1,1505,1706,3,201,1
32,2,1864,1713,7,151,1
126,1,1718,1941,2,223,1
95,2,1374,1740,6,366,0
55,2,1879,1747,10,132,1
149,2,1743,1498,1,245,1
83,2,1730,1754,5,24,0
30,2,2092,1733,8,359,1
144,1,1752,1465,4,287,0
123,2,1730,1753,4,23,0
41,1,1760,1908,9,148,1
104,0,1920,1755,7,165,0
24,1,1758,2112,7,354,1
39,2,1750,1634,3,116,1
92,1,1877,1733,10,144,0
109,2,1716,1857,3,141,0
70,1,1057,1716,4,659,1
49,2,1858,1723,4,135,1
77,2,1888,1723,2,165,1
95,2,1705,1927,3,222,0
136,1,2054,1683,1,371,0
46,1,1686,2022,5,336,1
21,1,1209,1685,4,476,1
52,1,1964,2331,5,367,1
58,1,1754,2329,5,575,1
43,2,2329,1613,12,716,1
59,2,2320,2132,10,188,1
76,1,2275,2303,9,28,1
62,1,1846,1788,11,58,0
97,2,1780,1677,4,103,1
62,2,1776,1460,6,316,1
36,1,1788,1600,6,188,0
118,1,1552,1783,1,231,1
71,2,1877,1792,4,85,1
51,0,1622,1797,3,175,0
45,2,1793,1519,5,274,1
41,2,1792,1178,4,614,1
54,1,1655,1785,6,130,1
92,1,1676,1777,4,101,1
59,2,1775,1337,5,438,1
64,1,1408,1772,4,364,1
103,0,1778,1579,8,199,0
106,1,1798,1390,5,408,0
69,2,1786,1816,9,30,0
41,2,1764,1798,7,34,0
69,2,1783,1916,7,133,0
44,1,1548,1517,7,31,0
99,0,1517,1548,4,31,0
164,1,1558,1583,7,25,1
42,2,1544,1636,7,92,0
107,0,1541,1651,5,110,0
58,1,1542,1530,2,12,0
23,2,1522,1486,9,36,1
20,1,1532,1567,7,35,1
62,2,1533,1544,7,11,0
57,2,1707,1550,3,157,1
58,0,1547,1664,2,117,0
17,2,1536,1534,5,2,1
37,2,1524,1536,5,12,0
81,2,1514,1511,4,3,1
72,1,1522,1502,7,20,0
19,2,1489,1378,9,111,1
46,2,1489,1511,9,22,0
7,1,1588,1489,5,99,0
74,1,1500,1489,3,11,0
28,1,1489,1567,5,78,1
21,2,1489,1566,4,77,0
21,2,1500,1489,2,11,1
17,1,1500,1489,3,11,0
35,1,1489,1511,3,22,1
72,1,1496,1500,9,4,1
9,2,1496,1508,4,12,0
76,1,1508,1496,2,12,0
25,2,1527,1496,5,31,1
32,1,1500,1496,1,4,0
67,2,1485,1489,7,4,0
31,2,1509,1496,4,13,1
57,2,2320,1500,12,820,1
61,2,2193,1500,12,693,1
50,1,1500,2193,13,693,1
39,2,1462,1500,2,38,0
47,2,1794,1816,7,22,0
91,2,1807,1741,5,66,1
14,2,1796,1805,5,9,0
69,1,1817,1784,3,33,0
62,1,1748,1774,1,26,1
73,2,1762,1805,6,43,0
18,1,1775,1728,3,47,0
31,2,2167,1777,9,390,1
64,1,1742,1767,5,25,1
110,1,1779,1735,6,44,0
175,2,1773,1613,4,160,1
117,2,1820,1782,10,38,1
34,1,1642,1775,5,133,1
28,1,1782,1914,7,132,1
51,2,1775,1665,7,110,1
74,2,1791,1785,5,6,1
48,1,1798,1725,1,73,0
71,2,1781,1809,4,28,0
33,2,1797,1865,9,68,0
40,1,1765,1787,6,22,1
107,2,1778,1701,3,77,1
40,1,1789,1796,6,7,1
23,2,1806,1799,6,7,1
27,2,1900,1806,6,94,1
100,1,1817,1809,5,8,0
31,2,1895,1825,9,70,1
41,2,1815,1792,5,23,1
12,2,1807,1827,7,20,0
23,2,1546,1845,7,299,0
87,2,1835,1819,5,16,1
132,1,1843,1902,5,59,1
72,2,1773,1856,3,83,0
164,0,1801,1858,7,57,0
41,2,1849,1810,4,39,1
30,1,1862,1764,6,98,0
73,2,1854,1765,5,89,1
50,1,1865,1845,3,20,0
107,2,1834,1877,2,43,0
29,2,2074,1883,7,191,1
32,1,1779,1875,7,96,1
108,1,1886,1864,11,22,0
51,2,1852,1898,4,46,0
79,2,1842,1800,10,42,1
90,0,1845,1746,5,99,0
98,1,1713,1735,9,22,1
139,2,1619,1727,4,108,0
79,0,1726,1760,4,34,0
139,2,1711,1738,4,27,0
100,1,1721,1727,4,6,1
42,1,1739,1701,4,38,0
61,2,1787,1749,8,38,1
54,1,1760,1740,6,20,0
43,2,1753,1611,5,142,1
78,0,1702,1755,6,53,0
57,2,1641,1770,3,129,0
90,1,1785,1616,8,169,0
116,1,1751,1775,11,24,1
104,1,1787,1739,3,48,0
101,2,1767,1799,6,32,0
93,2,1792,1688,6,104,1
84,0,1796,1652,5,144,0
47,2,1788,1665,6,123,1
66,1,1674,1781,8,107,1
80,1,1812,1693,7,119,0
108,1,1734,1803,6,69,1
81,2,1794,1724,5,70,1
96,1,1811,1603,3,208,0
56,0,1627,1816,6,189,0
41,2,1810,1641,3,169,1
31,2,1623,1827,5,204,0
59,2,1821,1620,3,201,1
31,2,1800,1647,3,153,1
151,2,1794,1648,4,146,1
52,1,1809,1662,9,147,0
47,2,1802,1660,11,142,1
88,1,1667,1795,6,128,1
70,1,1679,1788,5,109,1
71,2,1780,1686,9,94,1
42,1,1694,1771,8,77,1
16,1,1622,1765,3,143,1
98,1,1776,1759,3,17,0
72,1,1788,1740,7,48,0
56,1,1794,1724,3,70,0
74,1,1800,1959,3,159,1
77,2,1952,1807,5,145,1
48,1,1754,1797,5,43,1
39,2,2579,2036,4,543,1
44,1,2037,2577,8,540,1
33,2,2574,2039,2,535,1
92,1,2040,2571,8,531,1
53,2,2367,2043,8,324,1
53,2,2029,2099,18,70,0
49,2,2324,2033,14,291,1
72,1,2033,2368,10,335,1
97,2,2214,2039,12,175,1
61,2,2024,2154,7,130,0
77,2,2013,2022,6,9,0
49,2,2163,2020,10,143,1
185,0,2070,2018,10,52,0
43,2,2245,2023,8,222,1
35,2,2149,2031,6,118,1
74,2,2352,2366,7,14,0
161,2,2351,2363,5,12,0
86,1,1814,1662,4,152,0
56,1,1711,1778,4,67,1
16,1,1756,1778,11,22,1
87,2,1778,1656,11,122,1
17,1,1610,1778,3,168,1
107,2,1778,1932,6,154,0
55,2,1778,1723,4,55,1
89,0,1778,1795,10,17,0
104,1,1966,1761,3,205,0
113,2,1750,1755,4,5,0
19,1,1768,1738,8,30,0
87,2,1728,1681,9,47,1
58,1,1737,1811,10,74,1
160,0,1811,1735,9,76,0
64,2,1691,1748,3,57,0
10,1,1757,1830,5,73,1
80,1,1766,1820,5,54,1
154,1,1785,1527,6,258,0
52,1,1641,1778,3,137,1
19,2,1761,1790,9,29,0
61,2,1650,1806,8,156,0
55,2,1799,1657,8,142,1
55,2,1641,1816,8,175,0
17,2,1805,1788,10,17,1
34,1,1807,2179,6,372,1
130,2,1577,1825,3,248,0
58,1,1841,1681,6,160,0
150,1,1634,1836,3,202,1
135,2,1621,1853,8,232,0
119,2,1845,1758,7,87,1
59,2,1827,1857,9,30,0
81,2,1847,1812,7,35,1
62,1,1862,1736,5,126,0
113,0,1644,1868,2,224,0
71,2,1829,1868,8,39,0
45,2,1868,1645,5,223,1
103,2,1868,1675,8,193,1
41,2,1868,1662,8,206,1
116,1,1662,1868,6,206,1
60,1,1868,1662,4,206,0
142,1,1662,1868,7,206,1
84,1,1868,1706,8,162,0
29,1,1868,1769,9,99,0
81,2,1579,1868,5,289,0
35,2,1880,1868,7,12,1
65,1,1770,1868,9,98,1
62,1,1701,1868,7,167,1
12,1,1805,1868,3,63,1
46,2,1868,1614,7,254,1
95,2,1758,1868,3,110,0
20,1,1787,1074,6,713,0
51,2,1393,1787,4,394,0
4,1,1787,1393,1,394,0
27,2,1787,1296,3,491,1
40,1,1787,2188,12,401,1
31,1,1787,2188,4,401,1
40,1,1787,1500,5,287,0
16,0,1802,1787,1,15,0
42,1,1828,1787,5,41,0
72,1,1828,1674,7,154,0
39,2,1502,1830,3,328,0
33,2,1772,1583,9,189,1
59,2,1263,1803,4,540,0
45,2,1390,1500,3,110,0
45,2,1158,1294,6,136,0
46,2,1371,1158,6,213,1
37,2,1452,1172,7,280,1
40,1,1332,1105,4,227,0
3,2,1242,1134,3,108,1
3,2,1242,1134,3,108,1
44,1,1134,1500,9,366,1
65,2,1668,1134,11,534,1
16,1,1143,1558,2,415,1
47,2,2305,1883,4,422,1
32,1,1883,2305,2,422,1
25,2,2305,1883,7,422,1
55,1,1883,2305,2,422,1
118,1,2305,2085,8,220,0
102,1,2085,2305,5,220,1
96,1,1182,1062,3,120,0
45,2,1302,1278,5,24,1
105,2,1104,1175,5,71,0
94,1,1500,1172,5,328,0
42,1,1500,1500,5,0,0
15,2,1500,1500,6,0,0
47,2,1072,947,4,125,1
105,2,1801,1816,3,15,0
165,0,1578,1829,7,251,0
123,2,1807,1587,7,220,1
73,2,1779,1315,2,464,1
71,2,1735,1622,5,113,1
70,1,1772,1781,7,9,1
60,1,1794,1712,4,82,0
32,1,1765,1784,7,19,1
17,2,1836,1830,2,6,1
46,1,1558,1796,6,238,1
67,2,1746,1565,5,181,1
56,1,1573,1653,6,80,1
41,2,1500,1452,3,48,1
101,2,1576,1578,6,2,0
111,2,1727,1582,7,145,1
127,2,1670,1591,7,79,1
46,2,1582,1523,3,59,1
88,1,1592,1607,2,15,1
2,1,1629,1580,2,49,0
89,2,1593,1590,5,3,1
60,1,1600,1620,4,20,1
45,2,1590,1571,7,19,1
49,2,1586,1601,3,15,0
58,1,1612,1557,2,55,0
58,1,1590,1601,4,11,1
12,1,1612,1600,1,12,0
46,1,1587,1592,9,5,1
52,1,1602,1650,6,48,1
89,2,1596,1422,3,174,1
35,2,1585,1593,4,8,0
65,2,1573,1596,6,23,0
75,2,1539,1609,7,70,0
73,2,1589,1621,4,32,0
132,1,1632,1618,1,14,0
48,1,1624,1621,9,3,0
30,1,1630,1678,2,48,1
104,1,1638,1757,6,119,1
75,2,1661,1648,3,13,1
74,1,1668,1237,2,431,0
80,1,1517,1661,9,144,1
93,2,1661,1500,2,161,1
111,2,1621,1673,9,52,0
41,2,1670,1642,2,28,1
52,1,1532,1663,7,131,1
118,1,1638,1643,9,5,1
42,1,1684,1631,2,53,0
40,2,1621,1616,4,5,1
24,1,1413,1616,7,203,1
59,2,1607,1558,3,49,1
72,1,1594,1596,5,2,1
60,1,1588,1585,3,3,0
129,2,1576,1538,5,38,1
100,1,1508,1567,3,59,1
54,1,1560,1556,8,4,0
41,2,1547,1493,5,54,1
34,2,1537,1495,2,42,1
29,2,1594,1547,3,47,1
34,1,1394,1531,6,137,1
73,2,1522,1503,6,19,1
71,2,1816,1817,8,1,0
82,1,1831,1721,4,110,0
50,1,2043,1814,2,229,0
35,2,1802,1826,2,24,0
61,1,1615,1796,2,181,1
28,1,1804,1915,4,111,1
57,2,2005,1809,1,196,1
52,1,1817,1924,2,107,1
59,2,1806,1808,4,2,0
76,1,1826,2013,1,187,1
8,1,1391,1824,2,433,1
94,1,1839,1736,2,103,0
91,2,1828,1802,2,26,1
93,2,2318,1830,1,488,1
74,1,1746,1815,4,69,1
19,2,1810,1564,2,246,1
66,1,1797,1799,4,2,1
34,1,1435,1796,2,361,1
45,2,1591,1655,13,64,0
65,1,1879,1591,8,288,0
53,2,1562,1650,4,88,0
46,1,1602,1534,5,68,0
88,0,1538,1579,8,41,0
4,1,1606,1567,4,39,0
50,1,1651,1506,4,145,0
22,1,1709,1396,4,313,0
47,2,1677,1640,4,37,1
60,1,1650,1636,7,14,0
88,1,1772,1659,7,113,0
69,2,1659,1772,11,113,0
49,2,1659,1772,5,113,0
96,1,1866,1772,6,94,0
95,2,1744,1772,4,28,0
52,1,1772,1612,8,160,0
33,2,1772,1943,6,171,0
83,2,1943,1772,6,171,1
74,1,1775,1760,5,15,0
2,1,1710,1750,2,40,1
89,2,1870,1757,5,113,1
15,2,1750,1622,7,128,1
63,1,1726,1739,4,13,1
66,2,1720,1726,4,6,0
67,2,1714,1732,5,18,0
32,1,1744,1701,3,43,0
108,0,1689,1746,5,57,0
75,2,1551,1764,4,213,0
50,1,1649,1756,2,107,1
42,1,1659,1751,5,92,1
83,2,1739,1754,8,15,0
57,2,1742,1751,7,9,0
69,2,1738,1775,3,37,0
51,2,1731,1575,7,156,1
172,0,1571,1736,7,165,0
33,2,1728,1632,7,96,1
73,2,1570,1745,4,175,0
33,1,1675,1744,5,69,1
95,2,1737,1568,7,169,1
45,2,1659,1752,1,93,0
51,2,1641,1777,5,136,0
88,1,1793,1695,5,98,0
129,2,1816,1805,4,11,1
66,1,1874,1486,10,388,0
61,2,1833,1602,6,231,1
41,2,1691,1215,5,476,1
104,1,1280,1244,3,36,0
28,1,1297,1659,5,362,1
52,1,1427,1172,4,255,0
103,2,1572,1172,4,400,1
39,2,1552,1193,8,359,1
96,1,1209,1628,1,419,1
59,2,1118,1125,3,7,0
64,2,1177,1131,2,46,1
13,1,1019,1138,4,119,1
48,1,1176,1120,1,56,0
78,1,1138,1093,2,45,0
54,1,1156,1120,4,36,0
53,2,1114,820,2,294,1
35,2,1164,1130,2,34,1
49,2,1110,1148,2,38,0
43,2,1096,1012,1,84,1
65,2,1075,1116,1,41,0
57,2,1113,1209,3,96,0
88,1,1130,1203,2,73,1
60,1,1159,1068,4,91,0
128,1,1228,1128,5,100,0
167,2,1012,1164,4,152,0
80,1,1174,1453,7,279,1
21,2,1270,1226,4,44,1
87,2,1375,1248,2,127,1
53,2,1293,1282,4,11,1
61,2,1810,1686,2,124,1
33,2,1680,1499,6,181,1
54,2,1882,1686,2,196,1
101,2,1929,1690,9,239,1
63,2,1681,1614,4,67,1
135,2,1717,1664,9,53,1
80,1,1193,1421,3,228,1
65,2,1414,1271,4,143,1
38,1,1500,1404,2,96,0
66,1,1500,1394,3,106,0
41,2,1391,1041,7,350,1
40,1,1044,1388,2,344,1
69,1,1403,1314,12,89,0
34,1,1358,1392,2,34,1
48,1,1558,1372,9,186,0
31,2,1951,1500,4,451,1
44,1,1500,1951,4,451,1
23,2,1951,1435,5,516,1
52,1,1435,1951,4,516,1
27,2,1951,1500,2,451,1
54,1,1951,1875,9,76,0
51,1,1951,1848,2,103,0
86,1,1679,1951,4,272,1
29,2,1951,1679,5,272,1
78,1,1679,1951,4,272,1
97,2,1951,1513,5,438,1
54,1,1740,1951,7,211,1
73,2,1951,1475,5,476,1
70,1,1029,1753,1,724,1
41,1,1242,1336,5,94,1
81,2,1500,1336,6,164,1
68,1,1336,1500,4,164,1
30,1,1336,1500,3,164,1
9,2,1524,1500,5,24,1
22,0,1257,1500,2,243,0
73,2,1259,1252,3,7,1
28,1,1268,1318,4,50,1
31,2,1314,1278,3,36,1
109,0,1316,1276,3,40,0
72,1,1295,1374,4,79,1
13,2,1282,1358,5,76,0
125,2,1263,1293,6,30,0
37,2,1282,1309,2,27,0
78,2,1272,1246,4,26,1
78,1,1280,1366,4,86,1
17,2,1305,1290,2,15,1
33,2,1383,1299,7,84,1
24,1,1350,1286,6,64,0
52,1,1205,1278,5,73,1
15,2,1268,1215,4,53,1
128,1,1273,1480,5,207,1
59,2,1333,1283,3,50,1
145,2,1368,1291,4,77,1
40,1,1301,1341,6,40,1
25,1,1311,1349,5,38,1
22,1,1317,1490,4,173,1
54,1,1302,1306,4,4,1
53,2,1297,1236,4,61,1
105,2,1289,1195,4,94,1
48,1,1175,1281,9,106,1
13,2,1310,1291,8,19,1
44,1,1301,1368,5,67,1
15,2,1290,1320,4,30,0
33,2,1323,1301,8,22,1
73,2,1288,1329,3,41,0
52,1,1103,1283,12,180,1
28,1,1291,1396,4,105,1
55,0,1286,1442,5,156,0
21,2,1346,1296,7,50,1
27,2,1401,1304,4,97,1
48,1,1313,1374,4,61,1
87,2,1302,1304,6,2,0
51,2,1369,1312,6,57,1
27,2,1436,1319,2,117,1
47,2,1307,1382,4,75,0
20,1,1240,1297,7,57,1
42,1,1308,1337,2,29,1
59,2,1297,1276,4,21,1
36,1,1274,1285,5,11,1
20,2,1276,1179,5,97,1
51,2,1421,1284,7,137,1
58,1,1288,1587,5,299,1
53,2,1943,1500,2,443,1
26,1,1516,1500,5,16,0
7,2,1500,1500,5,0,0
76,1,1500,1500,5,0,0
47,2,1441,1500,8,59,0
92,1,1500,1560,2,60,1
55,2,1500,1500,2,0,0
60,1,1500,1500,4,0,0
55,2,1833,1500,4,333,1
79,2,1500,1500,5,0,0
39,2,1274,1311,2,37,0
32,1,1323,1348,4,25,1
23,2,1305,1483,2,178,0
66,1,1469,1285,5,184,0
96,1,1295,1758,2,463,1
154,1,1498,1274,6,224,0
94,1,1278,1582,6,304,1
47,1,1298,1119,7,179,0
85,2,1498,1304,3,194,1
63,2,1556,1310,4,246,1
77,2,1305,1023,4,282,1
119,2,1674,1308,6,366,1
87,2,1400,1259,2,141,1
57,2,1423,1400,2,23,1
60,1,1400,1476,2,76,1
72,1,1290,1400,1,110,1
73,2,1530,1400,2,130,1
27,2,1619,1400,2,219,1
44,1,1400,1619,3,219,1
72,1,1302,1400,2,98,1
113,2,1400,1475,3,75,0
46,2,1400,1476,2,76,0
16,2,1741,1400,2,341,1
73,2,1400,1028,2,372,1
106,0,1766,1400,2,366,0
51,2,1437,1400,2,37,1
18,1,1352,1400,2,48,1
95,2,1631,1400,5,231,1
18,2,1559,1400,2,159,1
64,1,1400,1635,2,235,1
9,2,1400,1381,3,19,1
25,1,1171,1400,2,229,1
59,2,1318,1400,2,82,0
85,2,1400,1372,2,28,1
30,1,1400,1387,3,13,0
15,2,1371,1400,2,29,0
66,1,1400,1349,3,51,0
38,1,1675,1400,2,275,0
18,1,1515,1400,2,115,0
81,2,1400,1332,2,68,1
58,1,1366,1400,2,34,1
31,1,1589,1400,2,189,0
49,2,1400,1466,3,66,0
44,1,1400,1437,2,37,1
65,2,1566,1400,1,166,1
40,1,1356,1400,2,44,1
28,1,1400,1395,2,5,0
56,1,1500,1400,2,100,0
19,2,1400,1396,2,4,1
105,2,1400,1412,2,12,0
40,1,1442,1400,1,42,0
66,1,1752,1960,3,208,1
31,1,1877,1940,9,63,1
33,2,1932,1644,3,288,1
8,1,1632,1924,4,292,1
9,2,1916,1620,2,296,1
79,2,1919,1945,8,26,0
49,2,1924,1832,2,92,1
54,1,1918,1891,5,27,0
79,2,1865,1781,2,84,1
16,2,1847,1657,2,190,1
30,1,1572,1832,5,260,1
41,2,1697,1890,8,193,0
65,2,1848,1823,2,25,1
49,1,1798,1796,4,2,0
59,2,1709,1871,5,162,0
37,2,1659,1555,1,104,1
22,1,1815,1378,2,437,0
78,1,1676,1741,8,65,1
67,2,1500,1430,2,70,1
50,1,1470,1453,4,17,0
42,2,1445,1464,6,19,0
100,1,1500,1456,5,44,0
63,2,1446,1424,3,22,1
64,1,1461,1434,7,27,0
66,1,1434,1513,5,79,1
7,2,1499,1442,1,57,1
107,2,1442,1566,5,124,0
37,2,1500,1442,7,58,1
259,0,1441,1461,5,20,0
101,2,1543,1448,2,95,1
21,0,1448,1458,2,10,0
120,1,1446,1494,7,48,1
69,2,1497,1456,4,41,1
82,1,1466,1527,4,61,1
19,2,1444,1500,4,56,0
75,2,1661,1450,11,211,1
134,1,1441,1438,5,3,0
20,1,1351,1471,6,120,1
94,1,1491,1346,5,145,0
70,1,1318,1483,5,165,1
58,1,1496,1511,4,15,1
44,1,1485,1482,7,3,0
117,2,1467,1456,6,11,1
31,1,1446,1452,5,6,1
65,2,1421,1429,6,8,0
37,2,1329,1443,6,114,0
39,2,1423,1484,3,61,0
35,2,1407,1377,3,30,1
82,1,1231,1397,5,166,1
11,1,952,1394,2,442,1
31,2,1390,967,3,423,1
46,1,1046,1030,3,16,0
13,2,1045,1119,2,74,0
14,1,1179,1329,1,150,1
69,2,1409,1228,2,181,1
48,2,1388,1326,2,62,1
28,1,1500,1503,1,3,1
4,1,1650,1812,4,162,1
43,2,1436,1668,4,232,0
78,1,1678,1715,4,37,1
75,2,1724,1688,8,36,1
39,2,1678,1630,5,48,1
41,2,1728,1688,8,40,1
98,1,1701,1638,8,63,0
62,1,1715,1652,5,63,0
61,2,1777,1725,9,52,1
100,1,1745,1747,4,2,1
37,2,1831,1745,12,86,1
125,2,1732,1747,4,15,0
30,1,1759,1719,2,40,0
43,0,1739,1719,2,20,0
80,1,1747,1588,4,159,0
63,2,1742,1506,5,236,1
49,2,1728,1772,3,44,0
39,2,2257,1730,3,527,1
102,1,1434,1726,1,292,1
38,1,1742,1602,6,140,0
105,2,1997,1747,2,250,1
35,1,1751,1992,3,241,1
35,2,1987,1757,8,230,1
82,1,1762,1971,5,209,1
83,2,1964,1768,8,196,1
89,2,1939,1795,1,144,1
22,1,1811,1696,4,115,0
39,2,1894,1820,2,74,1
34,1,1835,1733,28,102,0
45,2,1832,1503,4,329,1
88,1,2242,1811,6,431,0
39,2,2101,1824,4,277,1
62,1,1828,2097,5,269,1
102,1,1846,1622,2,224,0
41,2,2048,1852,3,196,1
36,1,1860,1969,4,109,1
81,1,1820,1850,3,30,1
71,2,1846,1551,8,295,1
32,1,1680,1839,4,159,1
65,2,1829,1777,4,52,1
68,1,1604,1824,8,220,1
87,2,939,963,4,24,0
66,2,1458,939,2,519,1
59,2,1449,940,4,509,1
80,1,949,1064,4,115,1
66,1,961,974,1,13,1
89,2,963,975,3,12,0
5,2,1046,986,3,60,1
95,2,1801,1784,2,17,1
41,2,1768,1773,7,5,0
108,0,1857,1763,4,94,0
108,1,1775,1890,6,115,1
92,1,1815,1724,8,91,0
62,1,1815,1872,6,57,1
47,2,1800,1741,5,59,1
168,1,1522,1793,2,271,1
27,2,1868,1808,4,60,1
21,2,1796,1643,7,153,1
58,1,1394,1792,5,398,1
63,2,1412,1410,6,2,1
28,1,1417,1565,2,148,1
49,2,1412,1174,3,238,1
20,1,1464,1397,3,67,0
68,1,1387,1385,3,2,0
107,0,1377,1645,3,268,0
140,1,1383,1588,3,205,1
200,1,1910,1827,4,83,0
80,1,1752,1818,4,66,1
47,2,1809,1762,6,47,1
51,2,1803,1658,5,145,1
71,2,1818,1813,6,5,1
88,1,1806,1802,5,4,0
158,0,1804,1757,5,47,0
85,2,1796,1700,5,96,1
162,1,1807,1786,3,21,0
60,1,1726,1799,8,73,1
141,2,1795,1523,6,272,1
43,2,1777,2054,3,277,0
104,0,1831,1776,4,55,0
55,1,1786,1795,8,9,1
79,2,1775,1791,4,16,0
51,2,1789,1786,6,3,1
109,2,1775,1761,4,14,1
41,2,1773,1786,5,13,0
81,2,1743,1799,7,56,0
131,2,1807,1809,5,2,0
60,1,1823,1729,8,94,0
44,1,1764,1814,2,50,1
83,2,1801,1881,4,80,0
52,1,1814,1723,4,91,0
80,1,1733,1806,2,73,1
73,2,1743,1819,7,76,0
190,0,1818,1849,3,31,0
92,1,1600,1652,8,52,1
63,2,1640,1672,2,32,0
54,1,1648,1765,6,117,1
30,2,1757,1656,11,101,1
48,1,1792,1640,8,152,0
54,1,1647,1785,11,138,1
42,1,1801,1631,8,170,0
50,1,1638,1795,5,157,1
29,2,1788,1645,8,143,1
48,1,1652,1781,11,129,1
78,1,1796,1636,13,160,0
90,1,1723,1622,4,101,0
47,1,1588,1622,4,34,1
53,2,1664,1652,2,12,1
47,2,1707,1674,7,33,1
71,2,1670,1685,4,15,0
97,2,1674,1680,5,6,0
47,2,1670,1685,4,15,0
58,1,1692,1792,4,100,1
122,0,1747,1692,2,55,0
111,2,1692,1747,5,55,0
91,2,1747,1692,6,55,1
53,2,1692,1747,7,55,0
130,1,1747,1692,4,55,0
43,2,1692,1747,3,55,0
121,2,1692,1747,5,55,0
110,1,1747,1692,5,55,0
96,1,1747,1692,8,55,0
43,2,1692,1747,3,55,0
81,0,1747,1692,6,55,0
129,2,1692,1747,4,55,0
164,0,1654,1692,3,38,0
79,2,1600,1692,3,92,0
54,1,1692,1637,5,55,0
128,1,1692,1637,3,55,0
80,1,1606,1684,6,78,1
62,1,1694,1704,7,10,1
44,2,1688,1705,4,17,0
73,2,1696,1657,2,39,1
9,1,1628,1688,4,60,1
53,2,1679,1626,2,53,1
83,2,1669,1663,2,6,1
97,2,1669,1573,3,96,1
82,1,1652,1659,2,7,1
36,1,1636,1649,7,13,1
26,1,1660,1622,3,38,0
53,2,1682,1670,3,12,1
114,1,1548,1670,4,122,1
77,2,1670,1548,2,122,1
57,2,1651,1670,1,19,0
93,2,1651,1670,3,19,0
65,2,1670,1659,7,11,1
99,2,2095,1679,16,416,1
69,2,1872,1685,6,187,1
34,1,1421,1680,3,259,1
37,2,1670,1625,5,45,1
72,1,1686,1676,2,10,0
61,2,1804,1698,4,106,1
87,2,1691,1567,5,124,1
49,2,1679,1690,6,11,0
11,2,1666,1702,5,36,0
66,1,1691,1643,3,48,0
27,2,1933,1696,11,237,1
25,2,1675,2055,5,380,0
102,1,1716,1661,5,55,0
60,1,1568,1653,2,85,1
45,2,1648,1630,5,18,1
99,2,1647,1664,6,17,0
41,2,1664,1632,3,32,1
55,2,1661,1322,3,339,1
51,2,1765,1669,7,96,1
72,1,1672,2052,5,380,1
97,2,1785,1680,6,105,1
48,1,1873,1913,4,40,1
61,2,1871,1456,7,415,1
13,2,1871,1098,7,773,1
80,2,1836,1884,8,48,0
101,2,1822,1886,4,64,0
68,1,1901,1806,6,95,0
87,2,1893,1768,3,125,1
104,1,1738,1886,2,148,1
81,2,1872,1940,6,68,0
21,2,1862,1809,5,53,1
65,2,1753,1871,5,118,0
46,1,1826,1860,3,34,1
80,1,1882,1504,5,378,0
96,1,1729,1874,13,145,1
118,1,1232,1874,8,642,1
74,2,2016,1889,8,127,1
76,1,2235,2447,4,212,1
56,1,1282,1472,5,190,1
82,1,1330,1464,4,134,1
38,1,1461,1559,5,98,1
55,2,1440,1777,8,337,0
58,1,1558,1423,3,135,0
73,2,1391,1437,6,46,0
36,2,1403,1451,2,48,0
90,1,1631,1432,11,199,0
86,1,1153,1428,3,275,1
49,2,1423,1158,4,265,1
64,1,1262,1416,3,154,1
29,2,1352,1431,1,79,0
64,1,1433,1869,2,436,1
62,1,1458,1044,4,414,0
59,2,1581,1466,7,115,1
41,2,1461,1246,7,215,1
45,2,1454,1289,8,165,1
29,2,1339,1470,7,131,0
99,2,1451,1865,5,414,0
47,2,1844,1453,8,391,1
86,2,1450,1136,2,314,1
54,1,1500,1500,1,0,0
22,1,1463,1500,2,37,1
107,2,2500,2205,4,295,1
23,2,2131,1869,4,262,1
58,2,1852,1805,4,47,1
64,1,1873,1858,10,15,0
71,2,1865,1623,7,242,1
128,1,1732,1850,7,118,1
72,1,1864,2011,8,147,1
76,1,2040,1827,17,213,0
79,2,1800,1508,5,292,1
19,2,1918,1820,7,98,1
35,1,1842,1915,7,73,1
47,1,1502,1834,6,332,1
99,2,1810,1728,7,82,1
58,1,1789,1776,8,13,0
95,2,1723,1708,2,15,1
41,2,1662,1808,8,146,0
44,2,1801,1697,9,104,1
50,1,1750,1761,4,11,1
47,2,1678,1717,5,39,0
99,2,1596,1643,6,47,0
79,2,2613,1904,8,709,1
75,2,1893,1897,8,4,0
57,2,2003,1901,7,102,1
101,0,1815,1904,5,89,0
226,0,1817,1907,3,90,0
105,2,1899,1776,4,123,1
78,1,1610,1895,2,285,1
129,2,1888,1736,6,152,1
59,2,2224,1802,3,422,1
70,1,1783,2222,3,439,1
93,2,2217,1970,3,247,1
74,1,1873,2214,3,341,1
62,2,2211,1878,6,333,1
28,1,1935,2206,8,271,1
57,2,2200,2029,6,171,1
27,2,2199,1622,6,577,1
64,1,1971,2194,3,223,1
138,0,2274,2191,3,83,0
90,1,1801,2189,3,388,1
37,2,2188,1536,4,652,1
106,1,2196,2314,9,118,1
114,1,2346,2179,12,167,0
29,2,2170,2112,3,58,1
47,2,2161,2084,9,77,1
53,2,2154,2010,3,144,1
57,2,2140,2218,12,78,0
48,1,2043,2132,2,89,1
43,2,2122,2052,6,70,1
115,2,2007,2138,2,131,0
57,2,2128,2064,4,64,1
156,1,1610,1578,3,32,0
35,2,1743,1594,2,149,1
96,2,1584,1591,4,7,0
54,1,1595,1563,4,32,0
44,1,1573,1597,3,24,1
150,1,1609,1552,2,57,0
106,1,1619,1632,8,13,1
40,1,1591,1609,5,18,1
53,2,1611,1557,5,54,1
75,2,1667,1620,3,47,1
57,2,1599,1631,5,32,0
113,0,1631,1627,2,4,0
29,2,1620,1639,5,19,0
113,2,1645,1630,11,15,1
205,2,1617,1704,3,87,0
62,1,1601,1607,8,6,1
49,2,1569,1619,8,50,0
17,2,1621,1593,4,28,1
37,2,1609,1688,2,79,0
127,2,1598,1619,3,21,0
153,0,1628,1666,6,38,0
30,1,1574,1619,3,45,1
61,2,1609,1590,9,19,1
88,1,1641,1598,11,43,0
71,2,1661,1606,10,55,1
48,1,1617,1616,5,1,0
58,1,1620,1606,4,14,0
79,2,1597,1565,4,32,1
73,2,1599,1607,5,8,0
40,1,1601,1597,2,4,0
48,1,1607,1600,5,7,0
54,1,1615,1704,5,89,1
73,2,1601,1626,2,25,0
48,1,1635,1666,4,31,1
43,2,1662,1645,2,17,1
48,1,1598,1636,2,38,1
45,2,1628,1556,5,72,1
54,1,1638,1639,2,1,1
34,1,1450,1999,9,549,1
53,2,1999,1450,9,549,1
77,2,1996,1959,5,37,1
32,2,1948,1942,6,6,1
113,2,1930,2204,10,274,0
39,2,1918,1966,4,48,0
17,2,2069,1925,4,144,1
75,2,1860,1938,4,78,0
28,1,1905,1924,5,19,1
93,1,1930,2107,3,177,1
42,1,1936,2101,5,165,1
126,1,1313,1543,2,230,1
8,1,1563,1290,2,273,0
67,2,1266,1585,2,319,0
49,1,1542,1242,4,300,0
88,0,1232,1551,3,319,0
28,1,1244,1282,3,38,1
35,2,1525,1249,2,276,1
86,2,1225,1546,3,321,0
65,2,1198,1613,1,415,0
66,1,1189,1621,4,432,1
63,2,1619,1191,2,428,1
35,2,1176,1201,2,25,0
22,1,1649,1176,3,473,0
14,2,1176,1649,5,473,0
67,2,1621,1176,3,445,1
106,1,1176,1621,3,445,1
96,1,1176,1615,5,439,1
115,2,1615,1176,4,439,1
113,2,1176,1615,6,439,0
69,2,1653,1176,4,477,1
58,1,1176,1653,3,477,1
54,1,1653,1176,3,477,0
21,0,1176,1653,5,477,0
67,2,1500,1176,5,324,1
79,2,1308,1185,2,123,1
45,2,1164,1326,5,162,0
73,2,1318,1173,2,145,1
114,1,1180,1361,2,181,1
18,2,1355,1188,1,167,1
48,1,1191,1623,6,432,1
116,1,1203,1267,4,64,1
42,1,1283,1182,6,101,0
71,2,1156,1449,7,293,0
45,2,1444,1161,4,283,1
114,1,1530,1552,3,22,1
26,1,1504,1543,2,39,1
35,2,1543,1601,5,58,0
63,0,1519,1543,2,24,0
119,2,1584,1553,2,31,1
84,1,1537,1543,7,6,1
38,0,1509,1544,5,35,0
65,2,1532,1570,5,38,0
40,1,1497,1532,6,35,1
51,2,1436,1546,5,110,0
61,2,1536,1498,3,38,1
71,2,1453,1550,9,97,0
57,2,1550,1429,3,121,1
51,1,1462,1541,1,79,1
53,2,1492,1554,1,62,0
65,2,1522,1566,2,44,0
94,0,1671,1563,1,108,0
26,1,1464,1555,11,91,1
133,2,1626,1564,3,62,1
111,2,1550,1639,7,89,0
25,2,1550,1527,4,23,1
38,1,1693,1535,7,158,0
52,1,1600,1535,2,65,0
64,1,1500,1535,7,35,1
30,1,1443,1528,1,85,1
85,1,1542,1517,1,25,0
77,2,1651,1524,2,127,1
54,1,1507,1513,5,6,1
166,1,1523,1556,6,33,1
73,2,1554,1523,5,31,1
91,2,1636,1506,5,130,1
90,1,1528,1495,3,33,0
55,2,1545,1490,2,55,1
52,1,1508,1562,6,54,1
31,2,1552,1518,3,34,1
23,2,1505,1565,6,60,0
35,1,1580,1492,3,88,0
15,2,1484,1401,4,83,1
28,1,1418,1475,3,57,1
35,2,1466,1406,8,60,1
51,2,1432,1478,2,46,0
60,1,1489,1475,2,14,0
64,1,1454,1479,2,25,1
71,2,1516,1489,7,27,1
40,1,1582,1489,3,93,0
45,2,1799,1578,4,221,1
78,1,1716,1464,5,252,0
10,0,1277,1464,7,187,0
60,2,1413,1280,6,133,1
48,0,1276,1461,6,185,0
41,2,1284,1436,4,152,0
49,2,1426,1500,3,74,0
93,2,1405,1040,5,365,1
25,2,1516,1413,7,103,1
46,1,1434,1401,4,33,0
37,2,1388,1447,5,59,0
36,2,1507,1396,1,111,1
17,2,1636,1400,3,236,1
30,1,1408,1498,2,90,1
50,1,1415,1577,3,162,1
24,1,1331,1413,3,82,1
67,2,1400,1452,6,52,0
21,2,1440,1421,4,19,1
65,2,1405,1557,14,152,0
45,2,1309,1419,4,110,0
72,1,1587,1403,3,184,0
123,1,1416,1349,4,67,0
50,1,1431,1317,2,114,0
80,1,1436,1669,4,233,1
40,1,1363,1418,7,55,1
34,1,1423,1650,2,227,1
106,1,1418,1445,3,27,1
65,2,1587,1424,4,163,1
43,2,1407,1620,4,213,0
57,2,1643,1424,3,219,1
115,2,1500,1430,4,70,1
11,1,1444,1358,3,86,0
61,1,1442,1420,8,22,0
39,2,1435,1453,2,18,0
45,2,1728,1458,2,270,1
33,2,1470,1469,7,1,1
22,2,1461,1355,6,106,1
57,1,1466,1657,6,191,1
51,2,1441,1479,6,38,0
55,2,1642,1485,4,157,1
56,1,1449,1475,6,26,1
55,2,1462,1504,3,42,0
43,2,1727,1466,11,261,1
65,2,1457,1386,5,71,1
25,2,1503,1468,6,35,1
61,2,1461,1316,4,145,1
100,0,1466,1583,2,117,0
58,1,1461,1455,3,6,0
71,2,1446,1344,4,102,1
39,2,1436,1388,2,48,1
51,2,1665,1360,5,305,1
35,2,2171,2064,11,107,1
43,2,2162,2088,10,74,1
54,1,2097,2152,5,55,1
47,2,2053,2167,11,114,0
51,1,1994,2160,2,166,1
59,0,2166,1997,9,169,0
88,1,1661,2069,10,408,1
68,1,2211,1637,4,574,0
64,1,1187,1635,3,448,1
104,1,1924,1774,4,150,0
68,1,1789,1899,11,110,1
65,2,1880,1679,6,201,1
43,2,2050,1880,11,170,1
50,1,1923,1911,4,12,0
63,1,1964,2005,6,41,1
3,2,1970,1832,3,138,1
127,2,1990,1970,4,20,1
53,2,1886,1970,10,84,0
138,1,1970,1886,8,84,0
135,2,1886,1970,14,84,0
29,2,1970,1500,5,470,1
34,1,1621,1970,5,349,1
17,2,1970,1710,6,260,1
35,2,1807,1970,5,163,0
46,0,1970,1208,3,762,0
80,1,2106,1970,4,136,0
141,2,1970,1506,5,464,1
96,1,1506,1970,3,464,1
25,2,1970,1500,4,470,1
42,1,1452,2085,2,633,1
60,1,1660,1450,9,210,0
58,1,1486,1654,6,168,1
42,1,1390,1649,4,259,1
45,2,2013,1652,3,361,1
71,2,1643,1573,3,70,1
110,1,1652,1735,8,83,1
85,2,1726,1661,6,65,1
20,1,1672,1717,6,45,1
152,1,1643,1660,7,17,1
22,1,1415,1655,6,240,1
57,2,1669,1326,3,343,1
92,1,1329,1660,1,331,1
130,1,1674,1926,8,252,1
66,1,1674,1500,12,174,0
76,1,1781,1674,6,107,0
95,2,1529,1674,4,145,0
80,1,1674,1708,6,34,1
21,1,1590,1640,3,50,1
91,2,2027,1640,6,387,1
84,0,2027,1640,11,387,0
86,1,1579,1416,2,163,0
137,0,1577,1634,7,57,0
103,2,1568,1509,3,59,1
47,2,1561,1380,3,181,1
29,2,1552,1471,2,81,1
63,2,1547,1330,3,217,1
39,1,1564,1386,2,178,0
115,0,1563,1609,3,46,0
99,2,1549,1609,3,60,0
92,1,1562,1536,3,26,0
48,1,1563,2139,7,576,1
90,1,1565,1947,3,382,1
102,1,1587,1553,2,34,0
93,2,1712,1559,7,153,1
29,2,1547,1583,4,36,0
60,1,1552,1763,3,211,1
54,1,1568,1439,3,129,0
104,1,1534,1557,4,23,1
59,2,1550,1560,3,10,0
69,2,1544,1350,4,194,1
96,1,1558,1519,4,39,0
50,1,1569,1576,4,7,1
44,1,1577,1714,2,137,1
55,1,1596,1327,3,269,0
105,2,1594,1238,4,356,1
72,1,1609,1485,4,124,0
25,2,1605,1354,7,251,1
105,2,1594,1574,3,20,1
65,2,1582,1575,4,7,1
33,2,1575,1405,4,170,1
39,2,1572,1251,2,321,1
60,1,1140,1571,3,431,1
51,2,1993,1573,6,420,1
64,1,1576,1915,3,339,1
45,2,1990,1578,1,412,1
70,1,1591,1536,6,55,0
23,2,1575,1725,3,150,0
44,1,1581,1747,7,166,1
99,2,1569,1615,4,46,0
56,1,1583,1482,7,101,0
67,1,1593,1644,2,51,1
39,2,1589,1299,3,290,1
31,1,1605,1416,2,189,0
222,1,1617,1614,2,3,0
111,2,1611,1418,4,193,1
23,2,1606,1392,4,214,1
19,2,1601,1402,3,199,1
40,1,1451,1594,4,143,1
43,1,1475,1396,4,79,0
92,1,1496,1229,3,267,0
76,1,1393,1398,6,5,1
63,2,1418,1405,7,13,1
18,1,1422,1267,5,155,0
73,2,1778,1425,3,353,1
20,1,1430,1669,6,239,1
84,1,1441,1474,6,33,1
27,2,1403,1455,9,52,0
24,1,1523,1440,4,83,0
68,1,1441,1620,4,179,1
51,2,1388,1456,3,68,0
11,2,1447,1335,7,112,1
121,2,1968,1447,2,521,1
42,1,1447,1500,11,53,1
43,2,1492,1458,6,34,1
41,2,1446,1420,6,26,1
22,1,1216,1440,3,224,1
83,2,1432,1306,5,126,1
63,2,1419,1446,1,27,0
76,1,1460,1457,2,3,0
18,1,1277,1452,3,175,1
149,2,1421,1468,5,47,0
157,2,1440,1272,5,168,1
41,2,1518,1452,5,66,1
44,1,1479,1056,4,423,0
111,2,1383,1498,4,115,0
51,2,1492,1248,6,244,1
56,0,1523,1491,5,32,0
65,2,1801,1496,3,305,1
126,0,1496,1496,8,0,0
40,1,1505,1650,4,145,1
158,1,1425,1492,2,67,1
120,0,1491,1520,4,29,0
32,1,1509,1480,11,29,0
19,2,1268,1158,3,110,1
33,2,1141,1268,4,127,0
15,0,1268,1141,3,127,0
85,2,1189,1244,2,55,0
17,2,1189,1443,3,254,0
86,1,1271,1261,4,10,0
7,2,1519,1324,1,195,1
73,2,1611,1423,7,188,1
65,2,1784,1538,8,246,1
130,1,1583,1567,6,16,0
28,1,1583,2203,4,620,1
44,1,1729,1615,9,114,0
54,1,1420,1402,3,18,0
48,1,1500,1701,5,201,1
55,2,1700,1324,5,376,1
36,1,1331,1472,5,141,1
11,1,1463,1315,6,148,0
59,2,1443,1323,3,120,1
16,1,1333,1382,4,49,1
63,2,1628,1337,5,291,1
44,1,1342,1556,5,214,1
60,2,1370,1353,6,17,1
33,2,1552,1359,2,193,1
66,1,1364,1632,3,268,1
30,2,1518,1371,6,147,1
18,2,1383,1383,6,0,0
36,2,1688,1386,6,302,1
82,1,1392,1612,4,220,1
102,1,1225,1385,3,160,1
51,1,1389,1675,5,286,1
30,2,1594,1395,5,199,1
82,1,1558,1360,5,198,0
44,1,1369,1460,2,91,1
54,1,1374,1579,4,205,1
53,2,1430,1385,4,45,1
80,1,1489,1369,6,120,0
14,1,1363,1514,2,151,1
11,2,1363,1559,6,196,0
20,2,1469,1372,5,97,1
44,2,1646,1376,5,270,1
73,2,1365,1347,4,18,1
55,1,1368,1754,8,386,1
51,2,1962,1368,3,594,1
122,1,1375,1539,4,164,1
54,2,1604,1380,5,224,1
7,2,1554,1387,3,167,1
61,1,1394,1528,4,134,1
50,2,1679,1398,1,281,1
53,2,1519,1406,5,113,1
55,2,1394,1414,4,20,0
15,2,1648,1399,5,249,1
27,2,1643,1404,3,239,1
82,2,1638,1409,5,229,1
32,1,1657,1389,5,268,0
66,2,1653,1394,5,259,1
9,2,1601,1399,4,202,1
39,2,1543,1407,2,136,1
21,2,1394,1427,4,33,0
80,2,1528,1402,4,126,1
63,2,1738,1405,4,333,1
84,2,1535,1413,5,122,1
62,1,1568,2060,3,492,1
15,1,1783,2060,7,277,1
104,1,2060,1614,4,446,0
30,1,1527,2060,6,533,1
50,1,2060,1527,5,533,0
45,2,1553,2060,5,507,0
40,1,2060,1546,2,514,0
30,1,1768,2060,9,292,1
95,2,1876,2060,3,184,0
34,1,2060,1882,6,178,0
37,2,2060,1500,4,560,1
63,2,1500,2060,3,560,0
43,2,1500,2060,3,560,0
95,2,2060,1932,2,128,1
37,2,2060,1754,6,306,1
53,2,1500,2060,2,560,0
26,1,1500,2060,3,560,1
54,1,2060,1639,6,421,0
72,1,1513,1569,5,56,1
46,1,1440,1553,9,113,1
40,1,1459,1532,8,73,1
58,1,1573,1356,6,217,0
47,2,1672,1595,5,77,1
13,1,1507,1570,6,63,1
62,2,1741,1589,4,152,1
29,2,1409,1644,11,235,0
67,2,1552,1649,7,97,0
66,1,1679,1816,10,137,1
83,1,1833,1594,10,239,0
67,2,1508,1681,6,173,0
80,1,1340,1567,2,227,1
73,2,1502,1346,2,156,1
18,1,1354,1445,4,91,1
33,2,1312,1366,3,54,0
50,1,1407,1354,3,53,0
48,1,1366,1297,2,69,0
95,2,1282,1380,4,98,0
65,2,1460,1389,3,71,1
50,1,1379,1378,5,1,0
27,2,1366,1391,4,25,0
149,2,1357,1300,4,57,1
73,1,1365,1479,2,114,1
66,1,1374,1435,3,61,1
35,2,1425,1383,3,42,1
74,1,1395,1377,2,18,0
92,1,1360,1384,3,24,1
103,2,1756,1387,2,369,1
105,2,1374,1462,2,88,0
88,0,1401,1373,3,28,0
41,1,1383,1651,4,268,1
2,1,1383,1522,2,139,1
77,2,1352,1642,4,290,0
47,2,1421,1361,2,60,1
106,1,1323,1351,6,28,1
79,2,1314,1355,3,41,0
45,1,1362,1461,4,99,1
70,1,1371,1453,3,82,1
31,2,1442,1379,3,63,1
58,1,1368,1464,8,96,1
52,1,1464,1301,2,163,0
27,2,1388,1464,6,76,0
58,1,1204,1464,5,260,1
48,1,1464,1441,4,23,0
29,2,1464,1540,5,76,0
20,2,1337,1464,8,127,0
134,1,1516,1464,5,52,0
19,2,1526,1473,1,53,1
47,2,1413,1487,11,74,0
53,2,1473,1587,6,114,0
20,1,1479,1633,6,154,1
56,1,1417,1470,5,53,1
92,1,1263,1454,4,191,1
81,2,1442,1487,7,45,0
95,2,1644,1447,5,197,1
110,1,1456,1767,6,311,1
49,1,1465,1523,3,58,1
123,2,1392,1479,7,87,0
81,2,1463,1641,5,178,0
66,1,1476,1386,4,90,0
64,1,1615,1461,8,154,0
87,2,1446,1579,6,133,0
49,2,1382,1459,7,77,0
36,1,1472,1406,4,66,0
16,1,1480,1594,5,114,1
76,1,1309,1474,9,165,1
70,1,1328,1467,6,139,1
27,0,1469,1368,9,101,0
52,1,1632,1453,4,179,0
66,1,1458,1666,4,208,1
2,1,1467,1510,2,43,1
78,1,1481,1380,4,101,0
51,2,1535,1491,10,44,1
17,2,1564,1500,8,64,1
20,1,1505,1690,3,185,1
74,1,1496,1492,1,4,0
67,2,1567,1500,8,67,1
16,1,1506,1662,8,156,1
56,1,1516,1546,7,30,1
90,1,1524,1597,2,73,1
63,2,1644,1532,7,112,1
47,2,1618,1540,7,78,1
115,0,1540,1543,4,3,0
85,2,1512,1642,7,130,0
39,2,1738,1517,5,221,1
212,0,1513,1634,4,121,0
16,2,1561,1523,5,38,1
32,1,1533,1553,5,20,1
47,2,1592,1542,6,50,1
24,2,1726,1547,5,179,1
54,1,1606,1535,2,71,0
163,2,1643,1542,7,101,1
42,1,1548,1710,4,162,1
129,2,1537,1575,6,38,0
79,2,1603,1546,7,57,1
33,1,1546,1700,8,154,1
100,1,1500,1546,3,46,1
36,1,1546,1500,8,46,0
15,2,1500,1546,11,46,0
57,2,1546,1642,7,96,0
120,1,1546,1533,5,13,0
59,1,1604,1533,5,71,0
41,2,1523,1508,7,15,1
118,1,1571,1510,7,61,0
17,2,1683,1516,2,167,1
44,1,1649,1501,3,148,0
30,1,1509,1617,7,108,1
114,1,1518,1560,11,42,1
61,2,1704,1523,3,181,1
133,0,1520,1637,7,117,0
109,2,1624,1528,7,96,1
65,2,1513,1656,3,143,0
143,2,1603,1521,3,82,1
127,2,1509,1585,13,76,0
79,2,1618,1516,6,102,1
32,1,1522,1702,7,180,1
129,2,1555,1532,7,23,1
58,2,1651,1539,7,112,1
20,1,1545,1714,3,169,1
13,2,1567,1555,4,12,1
28,1,1565,1563,5,2,0
77,1,1574,1632,7,58,1
36,1,1582,1663,6,81,1
69,2,1650,1590,5,60,1
47,2,1438,1436,3,2,1
42,1,1486,1420,2,66,0
109,0,1418,1472,6,54,0
71,2,1390,1470,1,80,0
83,2,1428,1403,3,25,1
109,2,1384,1498,1,114,0
75,2,1598,1391,3,207,1
74,1,1394,1764,1,370,1
104,1,1396,1889,2,493,1
85,2,1738,1399,3,339,1
53,2,1749,1403,3,346,1
82,1,1396,1389,3,7,0
74,1,1380,1375,5,5,0
83,2,1360,1395,4,35,0
125,2,1345,1345,2,0,0
135,2,1473,1352,2,121,1
72,1,1365,1442,2,77,1
61,2,1474,1376,4,98,1
16,1,1389,1465,1,76,1
34,1,1375,1372,3,3,0
87,0,1372,1375,4,3,0
37,2,1430,1388,5,42,1
47,1,1516,1362,7,154,0
47,2,1699,1378,9,321,1
27,2,1448,1394,3,54,1
34,1,1413,1431,3,18,1
62,1,1432,1477,3,45,1
26,2,1466,1453,3,13,1
59,1,1472,1550,4,78,1
61,1,1413,1449,3,36,1
81,2,1429,1500,2,71,0
61,2,1484,1454,1,30,1
18,1,1495,1419,3,76,0
57,2,1391,1360,4,31,1
118,1,1431,1350,6,81,0
12,1,1416,1302,5,114,0
39,1,1495,1240,6,255,0
62,1,1276,1322,6,46,1
20,1,1298,1218,5,80,0
67,2,1351,1258,3,93,1
72,1,1323,1293,5,30,0
58,2,1628,1348,4,280,1
6,1,1357,1871,1,514,1
60,1,1385,1683,3,298,1
59,2,1558,1457,6,101,1
54,1,1462,1249,4,213,0
53,2,2035,1757,4,278,1
56,1,2053,1840,4,213,0
36,1,1468,2052,6,584,1
63,2,2043,1964,4,79,1
49,2,1994,2057,5,63,0
36,1,1684,1717,4,33,1
83,2,1703,1783,6,80,0
58,1,1807,1687,9,120,0
35,2,1953,1691,8,262,1
25,2,1679,1698,6,19,0
70,1,1398,1661,10,263,1
45,2,1873,1667,3,206,1
35,2,1664,1315,6,349,1
99,2,1646,1833,8,187,0
65,2,1518,1582,5,64,0
75,2,1575,1420,2,155,1
65,2,1563,1615,9,52,0
135,2,1551,1585,7,34,0
57,2,1551,1585,8,34,0
61,2,1552,1538,10,14,1
63,2,1526,1564,4,38,0
88,1,1569,1747,5,178,1
66,1,1577,1695,3,118,1
37,1,1603,1565,1,38,0
62,1,1323,1560,7,237,1
110,1,1724,1544,4,180,0
35,2,1532,1556,3,24,0
97,2,1545,1543,3,2,1
96,1,1552,1705,11,153,1
57,2,1513,1575,6,62,0
45,2,1566,1499,10,67,1
49,2,1555,1566,5,11,0
23,2,1555,1566,4,11,0
72,1,1567,1759,9,192,1
125,2,1576,1779,10,203,0
31,2,1779,1576,7,203,1
25,2,1576,1669,10,93,0
56,1,1600,1576,3,24,0
104,1,1576,1600,8,24,1
47,2,1566,1520,5,46,1
29,1,1530,1556,5,26,1
37,2,1564,1567,4,3,0
30,1,1578,1534,2,44,0
60,1,1551,1568,4,17,1
79,1,1569,2101,4,532,1
54,1,1523,1559,4,36,1
71,2,1542,1815,6,273,0
32,1,1600,1542,6,58,0
107,2,1517,1553,2,36,0
70,1,1565,1536,5,29,0
48,1,1577,1512,4,65,0
53,2,1714,1584,6,130,1
75,2,1578,1430,4,148,1
36,1,1437,1571,3,134,1
61,2,1559,1594,5,35,0
95,2,1291,1464,4,173,0
25,2,1657,1301,8,356,1
60,1,1303,1889,10,586,1
59,2,1303,1223,6,80,1
33,2,1418,1303,3,115,1
53,2,1303,1500,7,197,0
38,1,1431,1312,8,119,0
59,2,1699,1315,2,384,1
36,1,1626,1291,3,335,0
60,1,1294,1669,2,375,1
15,2,1381,1305,3,76,1
34,0,1296,1544,7,248,0
18,1,1693,1667,4,26,0
3,1,1259,1693,2,434,1
9,2,1693,1259,6,434,1
55,2,1640,1706,4,66,0
38,1,1712,1907,7,195,1
66,1,1621,1703,5,82,1
38,1,1704,2406,4,702,1
63,2,2406,1704,7,702,1
140,1,1549,1697,3,148,1
99,2,1683,1776,5,93,0
42,2,1666,1872,11,206,0
111,2,1867,1671,6,196,1
33,2,1664,1883,11,219,0
38,1,1671,1806,9,135,1
45,2,2041,1674,6,367,1
21,2,1697,1684,10,13,1
71,2,1634,1698,1,64,0
24,0,1818,1694,2,124,0
109,0,1700,1502,5,198,0
84,2,1696,1404,5,292,1
29,2,1962,1700,6,262,1
48,1,1706,1874,6,168,1
28,1,1907,1689,7,218,0
41,2,1850,1696,7,154,1
60,1,1700,1991,6,291,1
48,1,1705,1889,8,184,1
49,2,1694,1721,6,27,0
74,1,1704,1712,7,8,1
55,2,1767,1713,1,54,1
52,1,1726,1686,7,40,0
32,1,1696,1715,7,19,1
93,2,2252,1716,5,536,1
78,0,1791,1714,5,77,0
38,1,1731,1875,3,144,1
43,2,1720,1738,4,18,0
20,1,1750,1708,5,42,0
80,1,1717,1745,10,28,1
94,0,1744,1717,5,27,0
51,2,1708,1649,4,59,1
106,1,1515,1885,4,370,1
68,1,1885,1515,2,370,0
68,1,1710,1885,3,175,1
55,2,1500,1885,14,385,0
96,1,1885,1500,8,385,0
53,2,1885,1645,6,240,1
34,1,1645,1885,3,240,1
3,2,1546,1885,2,339,0
54,1,1670,1885,5,215,1
64,1,1885,1500,5,385,0
76,2,1743,1757,7,14,0
50,1,1754,1772,6,18,1
84,1,1637,1746,3,109,1
47,1,1440,1742,8,302,1
51,2,1738,1462,6,276,1
28,2,1733,1487,3,246,1
66,1,1579,1726,1,147,1
45,2,1716,1657,5,59,1
73,2,1507,1735,3,228,0
78,1,1512,1729,1,217,1
82,1,1773,1653,2,120,0
13,2,1757,1874,3,117,0
57,2,1747,1655,5,92,1
34,1,1755,1871,10,116,1
106,1,1732,1743,3,11,1
70,1,1756,1813,3,57,1
111,2,1772,1768,4,4,1
59,2,1762,1580,6,182,1
33,2,1563,1781,5,218,0
20,1,1522,1776,4,254,1
42,1,1784,1904,4,120,1
35,2,2059,1789,2,270,1
24,1,1803,1744,5,59,0
60,1,1777,1791,11,14,1
87,2,1803,1803,2,0,0
62,1,1811,1955,8,144,1
52,1,1830,1623,3,207,0
59,2,1662,1849,5,187,0
67,2,1832,1941,10,109,0
88,1,1978,1814,2,164,0
32,1,1298,1382,6,84,1
19,2,1367,1440,12,73,0
174,0,1344,1368,2,24,0
83,2,1351,1465,6,114,0
85,2,1344,1140,7,204,1
69,2,1607,1349,8,258,1
79,2,1321,1510,3,189,0
74,1,1325,1644,7,319,1
80,1,1322,1311,4,11,0
101,2,1297,1500,6,203,0
62,1,1081,1290,2,209,1
65,2,1277,1280,6,3,0
83,2,1226,1293,4,67,0
69,2,1500,1299,11,201,1
44,1,1110,1292,3,182,1
73,2,1277,1293,5,16,0
12,1,1378,1492,3,114,1
21,2,1580,1501,6,79,1
30,1,1510,1545,7,35,1
170,1,1344,1487,4,143,1
47,2,1477,1441,8,36,1
42,1,1711,1729,4,18,1
56,1,1742,1700,7,42,0
27,2,1726,1710,3,16,1
96,2,1779,1719,4,60,1
101,2,1709,1671,4,38,1
73,1,1696,1698,2,2,1
33,2,1687,1708,4,21,0
70,1,1720,1675,3,45,0
31,2,1662,1744,5,82,0
72,1,1670,1764,3,94,1
52,1,1780,1656,7,124,0
30,1,1629,1645,6,16,1
47,2,1634,1641,7,7,0
50,1,1652,1623,5,29,0
142,0,1622,1653,4,31,0
99,2,1738,1629,3,109,1
64,1,1732,1615,6,117,0
56,1,1622,1768,3,146,1
55,2,1609,1677,3,68,0
55,2,1595,1696,3,101,0
37,2,1688,1603,8,85,1
68,1,1611,1721,3,110,1
57,2,1597,1701,3,104,0
42,1,1716,1582,7,134,0
12,1,1587,1786,6,199,1
49,2,1780,1593,3,187,1
31,2,1799,1598,4,201,1
86,1,1606,1704,4,98,1
100,1,1615,1658,7,43,1
65,2,1731,1623,6,108,1
79,2,1610,1691,2,81,0
79,2,1691,1618,7,73,1
51,2,1606,1655,5,49,0
27,2,1712,1622,6,90,1
69,2,1607,1729,2,122,0
33,2,1655,1617,10,38,1
55,2,1604,1668,5,64,0
47,2,1759,1611,8,148,1
66,1,1752,1595,8,157,0
101,2,1832,1600,4,232,1
63,2,1665,1609,3,56,1
63,2,1708,1617,7,91,1
71,2,1603,1688,5,85,0
48,2,1730,1611,5,119,1
31,2,1596,1746,4,150,0
105,2,1775,1602,3,173,1
41,1,1606,1828,5,222,1
41,2,1807,1612,4,195,1
63,2,1869,1616,6,253,1
49,2,2208,1885,6,323,1
180,1,2228,2193,7,35,0
47,2,2187,1974,13,213,1
52,1,1879,2183,5,304,1
47,2,2168,2189,7,21,0
29,2,2188,1763,4,425,1
68,1,2016,2180,9,164,1
35,2,2180,1494,4,686,1
24,1,1669,2178,8,509,1
61,2,2178,1414,2,764,1
71,2,2157,2355,9,198,0
43,2,2071,2175,8,104,0
48,1,1812,2172,3,360,1
31,2,2169,1736,2,433,1
25,2,2168,1650,5,518,1
38,1,1614,2167,3,553,1
15,2,2165,1651,5,514,1
50,1,1468,2165,4,697,1
69,2,2162,1814,11,348,1
20,1,1826,2159,9,333,1
102,1,2065,2149,4,84,1
83,2,2075,2165,5,90,0
57,2,2154,2084,2,70,1
72,1,2093,2143,11,50,1
68,1,2000,2135,2,135,1
55,2,2126,2007,8,119,1
100,0,2020,2120,4,100,0
51,2,2109,2028,8,81,1
67,2,2122,1859,2,263,1
42,1,1810,2118,2,308,1
88,1,2105,2104,2,1,0
84,1,2062,2090,9,28,1
93,2,1786,2118,1,332,0
100,1,2122,2446,2,324,1
41,2,2113,1954,2,159,1
56,1,1778,2109,3,331,1
59,2,2099,1974,2,125,1
66,1,1865,2092,3,227,1
72,1,1782,1602,3,180,0
89,2,1767,1921,5,154,0
98,1,1411,1702,4,291,1
32,2,1700,1263,6,437,1
37,2,1772,1710,11,62,1
47,2,1693,1834,8,141,0
113,2,1693,1500,8,193,1
45,1,1957,1923,4,34,0
113,2,1980,1967,3,13,1
66,1,1996,1955,7,41,0
64,1,1949,1957,9,8,1
54,1,1969,1938,9,31,0
22,1,2058,1955,3,103,0
73,2,1944,1947,4,3,0
51,2,1930,2032,10,102,0
50,1,2004,1918,6,86,0
46,1,2088,1902,7,186,0
45,1,1906,2161,2,255,1
37,2,2146,1911,4,235,1
19,2,1957,1920,5,37,1
55,2,1938,1930,4,8,1
71,2,1917,2002,6,85,0
64,1,1928,1920,13,8,0
36,2,1954,1938,10,16,1
10,2,1941,1948,2,7,0
3,0,1953,1999,3,46,0
65,2,1952,1954,4,2,0
42,2,1943,1963,7,20,0
42,1,1974,1961,3,13,0
57,2,2035,1983,5,52,1
85,0,1972,1973,6,1,0
70,0,1973,1973,2,0,0
140,1,1980,2085,5,105,1
61,2,2022,1989,4,33,1
78,1,2000,1917,7,83,0
37,2,1991,1930,3,61,1
79,2,2186,1996,2,190,1
80,1,1958,1987,4,29,1
9,2,1932,1989,3,57,0
31,2,1980,1946,6,34,1
53,2,1500,1165,6,335,1
62,1,1464,1513,3,49,1
52,2,1681,1520,3,161,1
61,2,1674,1528,2,146,1
84,1,1542,1472,8,70,0
81,2,1708,1549,4,159,1
25,2,1528,1873,4,345,0
55,2,1870,1531,3,339,1
42,1,1538,1683,9,145,1
67,2,1628,1547,1,81,1
117,2,1754,1553,2,201,1
56,1,1558,1768,10,210,1
58,2,1762,1564,5,198,1
23,2,1549,1664,4,115,0
98,1,1557,1664,5,107,1
48,1,1607,1543,5,64,0
94,1,1547,1832,4,285,1
49,1,1550,1927,4,377,1
83,2,1737,1562,2,175,1
36,1,1568,1752,4,184,1
58,1,1572,1874,8,302,1
77,2,1920,1575,5,345,1
39,1,1578,1916,8,338,1
101,2,1911,1581,7,330,1
111,2,1728,1588,5,140,1
52,1,1597,1659,2,62,1
30,1,1750,1155,3,595,0
16,1,1857,1734,5,123,0
32,1,1556,1728,2,172,1
95,2,1717,1740,8,23,0
37,1,1752,1752,5,0,0
74,1,1771,1447,8,324,0
54,1,1500,1766,11,266,1
58,1,1634,1759,8,125,1
80,1,1771,1722,5,49,0
53,1,1829,1757,4,72,0
44,1,1654,1750,4,96,1
71,2,1741,1661,11,80,1
64,1,1414,1737,4,323,1
47,2,1730,1577,7,153,1
74,1,1650,1721,7,71,1
33,2,1715,1524,4,191,1
34,2,1415,1734,3,319,0
53,2,1721,1785,6,64,0
13,2,1711,1683,5,28,1
61,1,1725,1637,16,88,0
40,1,1635,1716,4,81,1
8,2,1675,1729,2,54,0
36,2,1723,1522,4,201,1
16,1,1730,1877,8,147,1
50,1,1778,1717,4,61,0
59,2,1693,1729,4,36,0
41,2,1716,1758,4,42,0
55,2,1779,1725,5,54,1
22,1,1471,1721,3,250,1
45,2,1717,1443,5,274,1
36,2,1701,1837,5,136,0
54,1,1533,1855,5,322,1
63,2,2156,2058,2,98,1
30,1,1688,2154,2,466,1
54,1,2168,1872,5,296,0
48,1,1659,1625,3,34,0
49,2,1523,1673,6,150,0
109,2,1767,1566,2,201,1
68,1,1192,1539,2,347,1
106,1,1539,1500,5,39,0
54,1,1844,1539,4,305,0
33,2,1539,1844,9,305,0
36,1,1844,1539,4,305,0
28,1,1539,1844,5,305,1
29,2,1855,1539,5,316,1
30,1,1539,1802,3,263,1
6,1,1315,1539,3,224,1
73,2,1528,1539,4,11,0
22,1,1539,1229,3,310,0
58,1,1539,1500,5,39,0
80,1,1657,1644,3,13,0
50,1,1463,1500,4,37,1
26,1,1826,1500,3,326,0
89,0,1266,1500,2,234,0
98,1,1500,1457,7,43,0
41,2,1750,1500,2,250,1
45,2,1500,1741,3,241,0
10,1,1500,1569,2,69,1
54,1,1500,1591,9,91,1
28,1,1500,1500,5,0,0
30,1,1500,1756,5,256,1
52,1,1302,1500,7,198,1
75,2,1559,1500,2,59,1
32,2,1566,1580,3,14,0
35,2,1636,1580,7,56,1
38,1,1580,1595,4,15,1
28,1,1580,1500,5,80,0
78,1,1589,1650,6,61,1
50,1,1438,1583,3,145,1
36,1,1592,1624,6,32,1
55,2,1621,1602,4,19,1
57,2,1602,1579,4,23,1
65,2,1602,1628,13,26,0
30,1,1591,1602,4,11,1
48,1,1618,1591,2,27,0
71,2,1614,1601,3,13,1
54,1,1595,1590,5,5,0
35,1,1600,1621,5,21,1
41,2,1600,1609,7,9,0
31,2,1600,1631,7,31,0
99,2,1600,1603,3,3,0
56,2,1619,1600,9,19,1
33,1,1600,1581,9,19,0
48,1,1500,1600,1,100,1
30,1,1600,1720,7,120,1
27,2,1720,1600,3,120,1
34,1,1608,1589,3,19,0
95,2,1589,1553,7,36,1
40,2,1589,1664,6,75,0
163,2,1538,1589,2,51,0
87,2,1589,1595,2,6,0
79,2,1599,1599,4,0,0
44,1,1594,1589,3,5,0
70,1,1691,1589,7,102,0
15,2,1589,1691,8,102,0
46,1,1500,1589,8,89,1
37,2,1579,1577,3,2,1
105,2,1568,1569,7,1,0
32,2,1565,1568,7,3,0
50,1,1585,1557,3,28,0
25,2,1513,1569,4,56,0
28,1,1581,1514,11,67,0
66,1,1581,1597,4,16,1
37,2,1598,1592,3,6,1
138,1,1500,1592,2,92,1
67,2,1190,936,4,254,1
121,2,1597,1192,8,405,1
57,2,1524,1176,7,348,1
89,2,2109,2270,4,161,0
67,2,2270,1890,8,380,1
40,1,2154,2270,10,116,1
70,0,2115,2276,4,161,0
55,2,2191,2294,10,103,0
93,2,2294,2280,4,14,1
39,2,1877,1080,3,797,1
118,1,1097,1305,3,208,1
66,1,1112,1368,3,256,1
47,2,1374,1129,3,245,1
81,2,1604,1135,2,469,1
75,2,1364,1156,3,208,1
80,1,1954,2158,4,204,1
37,2,2151,1696,8,455,1
85,2,1853,2229,3,376,0
35,2,2224,1695,5,529,1
38,1,1859,2212,6,353,1
42,1,1920,2194,5,274,1
72,1,2092,2147,4,55,1
55,2,2094,2024,11,70,1
52,1,1543,2087,1,544,1
54,1,1952,2021,6,69,1
78,1,1496,1525,2,29,1
47,2,1500,1503,5,3,0
85,2,1515,1514,5,1,1
62,1,1524,1515,1,9,0
49,2,1512,1576,2,64,0
108,1,1590,1499,4,91,0
116,1,1532,1488,3,44,0
38,1,1497,1535,2,38,1
79,2,1525,1507,2,18,1
41,2,1495,1536,2,41,0
62,1,1503,1587,2,84,1
50,1,1530,1492,4,38,0
116,1,1501,1541,1,40,1
60,1,1512,1488,3,24,0
140,1,1501,1501,11,0,0
60,1,1510,1564,2,54,1
74,1,1520,1549,3,29,1
43,2,1566,1529,2,37,1
82,1,1539,1555,5,16,1
119,2,1544,1549,2,5,0
45,2,1596,1558,7,38,1
66,1,1532,1548,1,16,1
138,1,1559,1564,2,5,1
115,2,1546,1610,2,64,0
40,1,1566,1535,3,31,0
51,2,1523,1545,3,22,0
50,1,1557,1526,3,31,0
75,0,1590,1556,11,34,0
65,2,1522,1567,3,45,0
66,1,1577,1596,9,19,1
135,0,1579,1525,2,54,0
111,2,1632,1588,7,44,1
48,1,1627,1576,1,51,0
96,1,1585,1616,3,31,1
144,1,1519,1577,4,58,1
73,2,2032,1719,9,313,1
44,1,1118,1482,3,364,1
62,1,1120,1775,8,655,1
84,1,1143,1128,5,15,0
63,2,1051,1363,7,312,0
107,2,1684,1053,9,631,1
59,2,1012,1222,5,210,0
83,2,1500,1012,5,488,1
40,1,1028,1097,4,69,1
77,2,1442,1034,4,408,1
84,1,1347,1034,5,313,0
41,2,1500,1034,5,466,1
44,1,1034,1500,3,466,1
54,2,1405,1041,6,364,1
55,1,1054,1303,2,249,1
71,2,1580,1058,3,522,1
17,2,1467,1372,6,95,1
64,1,1381,1401,8,20,1
90,1,1042,1381,2,339,1
25,2,1500,1381,9,119,1
139,2,1510,1381,3,129,1
127,2,1381,1372,2,9,1
72,1,1381,1510,4,129,1
9,2,1288,1381,4,93,0
44,1,1381,1722,4,341,1
52,1,1392,1437,4,45,1
121,2,1635,1397,6,238,1
130,1,1405,1548,6,143,1
30,2,1406,1405,7,1,1
76,1,1405,1785,3,380,1
46,1,1728,1405,4,323,0
99,2,1505,1405,5,100,1
18,1,1405,1550,3,145,1
76,1,1500,1405,8,95,0
50,2,1340,1420,4,80,0
45,1,1432,1451,4,19,1
20,1,1448,1340,4,108,0
59,2,1715,1453,6,262,1
47,2,1450,1121,7,329,1
59,2,1715,1455,8,260,1
57,2,1096,1478,5,382,0
54,1,1480,1847,3,367,1
35,2,1932,1482,3,450,1
20,1,1390,1473,11,83,1
106,1,1486,1451,5,35,0
33,2,1484,1088,4,396,1
96,1,1319,1477,4,158,1
23,2,1461,1553,3,92,0
60,1,1481,1225,5,256,0
63,2,1890,1483,3,407,1
44,2,1387,1499,7,112,0
131,2,1892,1475,8,417,1
56,1,1602,1888,5,286,1
51,2,1886,1464,3,422,1
137,2,1907,1898,9,9,1
93,2,1822,1934,9,112,0
66,1,1946,1955,4,9,1
159,2,1722,1976,3,254,0
27,2,1971,1711,2,260,1
95,2,1878,1987,1,109,0
51,2,1983,1699,4,284,1
38,1,1779,1976,5,197,1
43,2,1969,1834,5,135,1
77,2,1919,1983,5,64,0
32,1,1801,1976,5,175,1
93,2,1968,1825,4,143,1
34,1,1842,1960,4,118,1
81,2,1950,1849,2,101,1
30,1,2012,1934,6,78,0
65,2,1909,1406,4,503,1
48,1,1500,1909,6,409,1
55,2,1904,1498,9,406,1
43,2,1904,1500,6,404,1
61,2,1903,1302,3,601,1
20,1,1571,1897,7,326,1
52,1,1941,1362,2,579,0
74,1,1356,1939,6,583,1
74,1,1293,1938,4,645,1
26,1,1471,1935,2,464,1
57,2,1931,1475,3,456,1
26,1,1675,1656,4,19,0
57,2,1675,1716,7,41,0
112,1,2123,2219,7,96,1
35,2,2210,2131,1,79,1
69,2,2110,2395,6,285,0
83,2,1585,2131,2,546,0
58,1,1655,2130,5,475,1
32,1,1190,1500,4,310,1
9,2,1500,1190,3,310,1
52,1,1190,1500,4,310,1
19,2,1500,1190,3,310,1
20,1,1190,1257,5,67,1
35,2,1500,1190,6,310,1
21,2,1190,1500,6,310,0
33,2,1500,1190,7,310,1
88,1,1332,1190,4,142,0
40,1,1190,2133,5,943,1
14,1,1205,1349,5,144,1
7,2,1500,1213,3,287,1
12,1,1214,1964,4,750,1
67,2,1460,1224,3,236,1
54,1,1237,1431,7,194,1
49,2,1425,1252,4,173,1
72,1,1252,1319,4,67,1
24,1,1252,1500,4,248,1
55,1,1252,1500,5,248,1
23,2,1340,1252,7,88,1
27,1,1272,1381,5,109,1
9,2,1345,1297,5,48,1
28,1,1328,1300,5,28,0
80,1,1256,1294,3,38,1
58,1,1399,1233,6,166,0
27,2,1159,1414,3,255,0
9,2,1476,1173,3,303,1
60,1,1189,1471,7,282,1
82,1,1205,1500,7,295,1
17,2,1450,1231,3,219,1
7,2,1444,1264,3,180,1
44,1,1313,1437,2,124,1
25,2,1340,1426,3,86,0
65,2,1292,1339,3,47,0
69,2,1421,1500,6,79,0
53,1,1821,2236,4,415,1
55,2,2225,2015,19,210,1
40,1,1843,2220,5,377,1
86,1,1541,2219,5,678,1
47,1,1936,2236,9,300,1
16,2,2233,1772,8,461,1
29,2,2209,2030,2,179,1
27,2,2209,1320,6,889,1
74,1,1900,2200,3,300,1
39,1,1856,2192,10,336,1
50,1,1818,2185,4,367,1
53,2,2182,1688,5,494,1
40,1,1690,2178,2,488,1
21,2,2174,1692,4,482,1
40,1,1957,2151,6,194,1
17,1,1741,2145,3,404,1
61,2,2191,1599,5,592,1
19,2,2181,1830,6,351,1
62,1,1640,2177,10,537,1
45,2,2174,1641,6,533,1
44,1,1439,2172,1,733,1
38,1,1959,2151,7,192,1
43,2,2138,1819,14,319,1
14,1,1822,2123,12,301,1
23,2,2123,1108,4,1015,1
41,2,2119,1571,7,548,1
118,1,1968,2083,4,115,1
58,2,2069,1707,5,362,1
43,1,2016,2069,3,53,1
66,1,2076,1990,3,86,0
51,2,1979,1537,4,442,1
72,1,2071,2002,4,69,0
69,2,1999,1890,5,109,1
32,1,1916,1830,5,86,0
108,1,1726,1500,13,226,0
94,1,1450,1500,1,50,1
34,1,1264,1500,3,236,1
77,2,2011,1500,6,511,1
133,0,2300,2198,4,102,0
82,1,2103,2294,2,191,1
67,2,2290,2004,10,286,1
80,1,2008,2286,3,278,1
68,1,2303,2108,5,195,0
119,2,2299,2015,5,284,1
95,2,2270,2312,3,42,0
46,1,2321,2300,2,21,0
47,2,2287,2335,2,48,0
41,2,2225,2301,5,76,0
65,2,2179,2317,4,138,0
61,2,2305,2311,3,6,0
144,1,2074,2300,4,226,1
105,2,2290,2235,7,55,1
43,2,2287,1956,3,331,1
20,1,1959,2283,2,324,1
89,2,2279,2037,2,242,1
55,2,2267,2247,2,20,1
101,2,2320,2278,5,42,1
83,2,2274,2004,3,270,1
102,1,2282,2393,4,111,1
66,1,2293,2326,2,33,1
45,1,2000,2289,28,289,1
161,2,2280,2276,2,4,1
62,1,2293,2264,7,29,0
81,2,2280,2303,4,23,0
52,1,2291,2342,2,51,1
46,1,2052,2286,5,234,1
46,1,2255,2274,3,19,1
27,2,2270,1968,6,302,1
68,1,1941,2266,4,325,1
53,2,2264,1842,8,422,1
70,1,1902,2261,6,359,1
32,1,2163,2252,5,89,1
71,2,2249,1877,7,372,1
59,0,2362,2245,5,117,0
44,1,2264,2072,3,192,0
89,2,2259,2017,3,242,1
43,2,2255,2272,1,17,0
74,1,2287,2070,3,217,0
74,1,2007,2283,10,276,1
135,1,1537,1552,5,15,1
128,1,1354,1546,3,192,1
40,2,1629,1555,5,74,1
57,2,1543,1572,4,29,0
49,1,1552,1607,4,55,1
61,2,1348,1569,1,221,0
49,2,1446,1592,2,146,0
69,2,1582,1556,7,26,1
110,1,1589,1721,7,132,1
32,2,1555,1601,2,46,0
95,2,1591,1565,4,26,1
111,2,1583,1513,5,70,1
47,1,1523,1574,3,51,1
42,1,1560,1563,7,3,1
51,2,1553,1552,3,1,1
66,1,1500,1731,4,231,1
29,1,1500,1461,3,39,0
79,2,1464,1500,4,36,0
82,1,1500,1461,4,39,0
169,2,1631,1500,1,131,1
58,1,1500,1606,3,106,1
41,2,1704,1500,3,204,1
48,2,1856,1500,5,356,1
86,1,1500,1693,6,193,1
52,1,1380,1236,3,144,0
44,1,1037,1377,4,340,1
22,1,1006,1375,3,369,1
31,2,1361,1429,6,68,0
82,2,1345,1373,5,28,0
28,1,1161,1368,1,207,1
39,2,1357,1337,4,20,1
102,1,1667,1723,12,56,1
72,1,1829,1807,14,22,0
59,2,1816,1877,7,61,0
57,2,1868,1826,8,42,1
29,2,1821,1838,7,17,0
46,1,1851,1803,4,48,0
178,1,1861,1910,5,49,1
44,1,1886,1836,3,50,0
66,1,2102,1816,5,286,0
34,2,2105,1816,11,289,1
71,1,1816,2105,5,289,1
26,2,2105,1816,15,289,1
90,1,1816,2105,5,289,1
60,1,2052,1797,2,255,0
37,2,2047,1802,7,245,1
60,1,1807,2042,22,235,1
23,2,1883,1816,5,67,1
55,2,1810,1623,6,187,1
36,1,1816,1995,11,179,1
121,2,1988,1823,9,165,1
80,1,1828,2052,14,224,1
121,2,1809,2059,11,250,0
24,2,1970,1816,7,154,1
24,1,1824,1962,8,138,1
48,1,1828,2072,5,244,1
104,0,1864,1827,7,37,0
135,2,1788,1892,3,104,0
132,0,1768,1896,6,128,0
67,2,1888,1776,13,112,1
39,2,1760,1904,9,144,0
90,1,1756,1897,9,141,1
96,1,1910,1849,7,61,0
165,0,1539,1920,6,381,0
74,1,1611,1914,3,303,1
113,2,1910,1658,5,252,1
102,1,1449,1908,6,459,1
107,2,1726,1354,6,372,1
64,1,1401,1717,3,316,1
85,2,1704,1500,5,204,1
74,1,1035,1703,7,668,1
93,2,1703,1500,11,203,1
142,1,1500,1703,9,203,1
79,2,1703,1500,7,203,1
37,2,1141,1762,5,621,0
42,1,1145,1760,7,615,1
23,2,1758,1166,6,592,1
100,1,1466,1501,8,35,1
61,2,1983,1500,5,483,1
137,2,1337,1662,1,325,0
59,2,1500,1500,3,0,0
50,1,2003,1985,6,18,0
37,2,1979,1826,8,153,1
63,2,1969,1928,5,41,1
52,1,1984,1857,8,127,0
53,2,1976,1875,6,101,1
57,2,1860,1991,7,131,0
81,2,1984,1846,5,138,1
46,1,1848,1977,11,129,1
23,2,1969,1871,4,98,1
74,1,1947,1958,9,11,1
23,2,1947,1958,4,11,0
34,1,1500,1947,4,447,1
32,1,1500,1947,3,447,1
26,1,1500,1947,3,447,1
122,0,1946,1976,6,30,0
81,2,1965,1957,5,8,1
87,1,1964,2087,5,123,1
58,1,1837,1956,7,119,1
152,1,1837,1948,4,111,1
34,1,1929,1938,4,9,1
74,1,1994,1924,3,70,0
70,1,1935,1924,7,11,0
48,1,1938,1923,5,15,0
94,1,1935,1924,10,11,0
51,1,1938,1923,4,15,0
21,2,1913,1849,8,64,1
42,2,1901,1918,8,17,0
89,2,1891,1832,6,59,1
78,1,1842,1881,5,39,1
73,2,1870,1839,5,31,1
53,2,1860,1801,6,59,1
74,1,1871,1878,3,7,1
43,1,1793,1862,1,69,1
93,0,1864,1786,9,78,0
111,2,1770,1880,6,110,0
82,1,1891,1910,13,19,1
63,2,1882,1775,9,107,1
58,1,1729,1874,6,145,1
61,2,1863,1818,5,45,1
92,1,1876,1869,7,7,0
34,2,1865,1804,4,61,1
70,1,1754,1856,3,102,1
70,2,1842,1858,11,16,0
50,1,1603,1836,7,233,1
19,2,1830,1609,4,221,1
65,2,1273,1477,1,204,0
196,1,1285,1271,1,14,0
138,1,1295,1361,1,66,1
114,1,1299,1580,1,281,1
111,2,1285,1336,1,51,0
135,0,1283,1351,1,68,0
45,2,1264,1520,1,256,0
35,2,1251,1302,1,51,0
54,1,1262,1289,1,27,1
104,1,1276,1201,1,75,0
70,1,1285,1362,1,77,1
84,1,1287,1702,1,415,1
86,1,1289,1701,1,412,1
209,2,1272,1469,1,197,0
118,1,1276,1512,1,236,1
94,1,1285,1371,1,86,1
89,2,1267,1484,1,217,0
165,0,1264,1368,1,104,0
48,1,1272,1378,3,106,1
102,0,1265,1503,4,238,0
142,1,1256,1785,1,529,1
80,1,1267,1270,1,3,1
46,1,1271,1433,1,162,1
38,1,1282,1261,1,21,0
58,1,1289,1415,1,126,1
68,1,1301,1291,1,10,0
120,1,1307,1524,1,217,1
94,2,1295,1328,1,33,0
130,1,1297,1655,1,358,1
167,0,1296,1341,1,45,0
76,1,1297,1830,1,533,1
72,1,1303,1480,1,177,1
80,2,1290,1337,1,47,0
104,1,1297,1464,1,167,1
48,1,1298,1801,3,503,1
36,1,1307,1389,3,82,1
144,1,1309,1737,1,428,1
110,1,1320,1309,1,11,0
44,1,1330,1385,1,55,1
132,1,1343,1284,1,59,0
53,2,1329,1427,1,98,0
100,1,1341,1323,3,18,0
85,2,1332,1252,1,80,1
80,1,1338,1527,1,189,1
36,1,1346,1456,1,110,1
25,2,1333,1376,1,43,0
156,1,1345,1347,1,2,1
72,2,1341,1053,1,288,1
58,1,1484,1711,1,227,1
65,2,1617,1563,11,54,1
88,1,1574,1607,3,33,1
45,2,1612,1618,3,6,0
107,1,1657,1636,4,21,0
63,0,1657,1640,2,17,0
34,1,1991,1984,5,7,0
110,0,1991,2073,4,82,0
113,2,2100,2212,11,112,0
29,2,2260,2212,20,48,1
65,2,2200,2188,15,12,1
45,0,2182,2201,12,19,0
28,1,2213,2224,9,11,1
30,0,2089,2218,20,129,0
73,0,2223,2084,7,139,0
23,2,2213,2105,8,108,1
45,2,2205,2072,11,133,1
59,2,2201,1835,11,366,1
73,2,2197,1875,2,322,1
58,1,2148,2185,2,37,1
57,2,2200,2183,13,17,1
43,2,2334,1346,3,988,1
29,2,1368,1239,1,129,1
9,2,1446,1247,3,199,1
86,1,1260,1326,7,66,1
52,2,1233,1500,4,267,0
75,2,1491,1240,5,251,1
91,2,1240,1312,3,72,0
75,2,1548,1245,5,303,1
27,0,1232,1547,4,315,0
77,2,1188,1245,3,57,0
16,2,1517,1193,4,324,1
8,2,1193,1430,2,237,0
77,2,1351,1204,3,147,1
22,1,1209,1581,5,372,1
53,2,1369,1221,2,148,1
22,1,1227,1524,2,297,1
42,2,1634,1231,5,403,1
66,1,1236,1618,3,382,1
105,2,1353,1251,2,102,1
157,2,1220,1368,3,148,0
17,2,1361,1235,2,126,1
47,2,1456,1246,5,210,1
6,1,1254,1543,3,289,1
16,1,1265,1501,5,236,1
47,2,1829,1267,5,562,1
24,1,1269,1828,2,559,1
49,2,1596,1277,4,319,1
12,2,1427,1236,4,191,1
13,2,1291,1368,4,77,0
68,1,1450,1637,6,187,1
16,1,2081,2095,3,14,1
14,1,1653,2079,5,426,1
85,0,2076,2123,8,47,0
60,1,1917,2069,7,152,1
94,1,1986,2059,3,73,1
31,2,2051,1941,6,110,1
95,2,2041,1987,6,54,1
24,1,1900,2034,6,134,1
52,1,2007,2023,3,16,1
33,2,2015,1876,1,139,1
95,1,2184,1998,11,186,0
21,2,1992,1765,2,227,1
84,1,2083,1977,13,106,0
23,2,1970,1823,2,147,1
24,2,1746,1989,10,243,0
59,2,1975,2034,14,59,0
89,2,1988,1987,4,1,1
24,1,1905,1977,10,72,1
75,2,1974,1636,2,338,1
37,2,1973,1399,8,574,1
48,1,1613,1970,2,357,1
49,2,1963,1837,6,126,1
76,1,1612,1960,1,348,1
41,2,1955,1696,7,259,1
49,2,1943,1983,4,40,0
85,2,1933,1881,2,52,1
171,2,1894,1946,8,52,0
72,1,2121,1929,3,192,0
91,2,1916,1943,7,27,0
40,1,1550,1913,4,363,1
32,2,1963,1924,4,39,1
45,2,1907,2051,7,144,0
119,0,1961,1905,3,56,0
57,2,1899,1702,4,197,1
66,1,1902,1886,5,16,0
65,2,1881,1671,6,210,1
49,2,1875,1680,2,195,1
74,2,1871,1500,2,371,1
124,1,2106,1852,8,254,0
125,0,1844,2110,6,266,0
111,2,1500,1262,4,238,1
60,1,1780,1846,3,66,1
65,2,1750,1863,1,113,0
70,1,1628,1857,3,229,1
151,2,1841,1929,4,88,0
120,1,1624,1835,10,211,1
82,1,1301,1123,1,178,0
33,2,1395,1309,4,86,1
39,2,1300,1321,2,21,0
91,1,1328,1429,1,101,1
79,2,1415,1337,2,78,1
51,2,1502,1343,4,159,1
96,1,1320,1333,3,13,1
39,1,1345,1308,1,37,0
53,2,1339,1177,1,162,1
86,1,1349,1368,1,19,1
34,1,1380,1337,3,43,0
46,1,1173,1331,4,158,1
17,2,1327,1211,1,116,1
69,2,1313,1339,5,26,0
38,1,1351,1298,1,53,0
48,1,1292,1342,8,50,1
87,2,1480,1349,6,131,1
56,1,1357,1472,1,115,1
52,1,1295,1347,1,52,1
61,0,1570,1352,3,218,0
36,1,1357,1565,1,208,1
59,1,1427,1343,3,84,0
85,2,1486,1350,1,136,1
33,2,1325,1362,2,37,0
67,2,1627,1366,3,261,1
16,1,1421,1354,3,67,0
66,1,1277,1345,3,68,1
45,2,1377,1355,4,22,1
38,1,1365,1388,1,23,1
54,1,1459,1351,1,108,0
47,2,1340,1341,3,1,0
88,1,1353,1288,4,65,0
25,1,1317,1343,2,26,1
115,2,1418,1343,2,75,1
50,1,1354,1360,4,6,1
53,2,1373,1357,4,16,1
102,1,1363,1238,5,125,0
52,1,1254,1354,3,100,1
55,2,1179,1371,1,192,0
46,1,1381,1359,2,22,0
56,1,1374,1272,3,102,0
109,2,1639,1656,4,17,0
35,2,1641,1490,1,151,1
63,2,1636,1260,1,376,1
20,2,1625,1378,1,247,1
59,2,1845,1638,3,207,1
64,1,1654,1839,9,185,1
70,1,1696,1563,1,133,0
130,1,1661,1664,2,3,1
78,1,1630,1642,4,12,1
76,1,1284,1639,8,355,1
36,2,1636,1260,3,376,1
37,2,1629,1450,3,179,1
31,2,1615,1673,6,58,0
117,2,1666,1626,2,40,1
60,2,864,1651,6,787,0
29,2,1650,864,7,786,1
51,2,1305,1671,3,366,0
39,2,1669,1308,6,361,1
89,0,1591,1671,2,80,0
85,2,1632,1684,2,52,0
61,2,1777,1693,12,84,1
126,1,1523,1687,4,164,1
15,2,1680,1530,7,150,1
55,2,1632,1693,5,61,0
113,0,1711,1693,9,18,0
56,1,1708,1615,5,93,0
30,2,1999,1712,8,287,1
85,2,1636,1727,13,91,0
125,1,1743,1622,9,121,0
48,1,1614,1735,2,121,1
65,2,1561,1299,2,262,1
62,1,1301,1687,2,386,1
96,2,1630,1305,4,325,1
36,1,1320,1223,1,97,0
62,1,1327,1506,2,179,1
75,2,1517,1333,5,184,1
160,1,1336,1705,2,369,1
48,1,1345,1448,2,103,1
86,1,1465,1287,3,178,0
71,2,1559,1292,4,267,1
57,2,1404,1300,4,104,1
58,1,1304,1646,1,342,1
126,1,1307,1631,2,324,1
98,0,1306,1325,1,19,0
155,2,1471,1314,6,157,1
48,1,1266,1302,1,36,1
31,2,1291,1246,3,45,1
20,1,1307,1212,2,95,0
20,0,1297,1308,3,11,0
118,1,1319,1368,4,49,1
70,1,1639,1296,3,343,0
32,1,1286,1730,2,444,1
47,2,1715,1289,2,426,1
103,2,1264,1792,1,528,0
111,2,1239,1211,2,28,1
57,2,1455,1245,2,210,1
86,1,1261,1639,1,378,1
83,2,1238,1665,4,427,0
25,1,1425,1220,3,205,0
114,1,1224,1506,2,282,1
123,2,1205,1421,2,216,0
65,2,1605,1207,2,398,1
69,2,1943,1207,3,736,1
74,1,1210,1604,1,394,1
51,2,1682,1211,2,471,1
102,1,1212,1946,2,734,1
25,2,1397,1218,3,179,1
43,2,1609,1203,3,406,1
124,0,1204,1170,2,34,0
123,2,1306,1212,1,94,1
16,1,1558,1882,9,324,1
45,2,1859,1895,9,36,0
69,2,1951,1893,15,58,1
41,2,1887,1699,4,188,1
37,2,2209,1887,9,322,1
55,2,1725,1905,5,180,0
71,2,1500,1451,1,49,1
136,1,1401,1618,1,217,1
74,1,1632,1533,5,99,0
45,0,1530,1635,5,105,0
50,1,1654,1368,5,286,0
95,2,1647,1531,5,116,1
154,1,1494,1640,3,146,1
108,1,1539,1632,4,93,1
118,0,1820,1616,7,204,0
109,2,1606,1594,6,12,1
55,2,1594,1608,4,14,0
115,2,1621,1605,3,16,1
43,1,1605,1593,7,12,0
100,1,1589,1928,4,339,1
39,2,1581,1493,3,88,1
36,1,1523,1571,3,48,1
10,1,1248,1568,4,320,1
59,2,1564,1318,4,246,1
92,1,1582,1590,4,8,1
210,1,1600,1571,4,29,0
83,2,1555,1711,4,156,0
29,2,2621,1555,10,1066,1
120,1,1584,1543,4,41,0
147,2,1536,1500,5,36,1
45,2,1594,1545,8,49,1
63,0,1546,1522,4,24,0
71,2,1575,1566,4,9,1
116,1,1562,1554,4,8,0
40,1,1567,1520,6,47,0
73,2,1500,1567,5,67,0
107,0,1566,1585,6,19,0
2,2,2430,1566,2,864,1
72,1,1538,1556,1,18,1
183,2,1714,1705,4,9,1
88,1,1587,1557,6,30,0
14,2,1653,1566,5,87,1
52,2,1546,1579,8,33,0
74,1,1596,1441,4,155,0
25,2,1582,1634,4,52,0
59,1,1586,1863,4,277,1
45,2,1717,1595,8,122,1
39,2,2029,1597,6,432,1
43,2,1686,1606,6,80,1
169,0,1604,1681,8,77,0
56,2,1615,1623,6,8,0
154,1,1628,1856,4,228,1
42,1,1319,2296,3,977,1
35,2,2296,1319,3,977,1
44,1,1319,2296,3,977,1
41,2,2296,1319,5,977,1
57,2,2294,1742,6,552,1
48,1,1319,2294,3,975,1
39,2,2294,1319,5,975,1
32,1,1319,2294,2,975,1
19,2,2294,1319,7,975,1
35,2,2294,1319,4,975,1
32,1,1319,2294,4,975,1
9,2,2294,1319,6,975,1
185,2,1363,1095,7,268,1
76,1,1095,1187,5,92,1
8,2,1175,1111,3,64,1
39,2,1076,1440,3,364,0
28,2,1221,1088,4,133,1
46,1,1059,1368,4,309,1
56,1,1368,1059,6,309,0
60,1,1059,1500,4,441,1
53,1,1080,1080,4,0,0
19,2,1793,1081,2,712,1
43,2,2364,1703,7,661,1
48,1,1704,2363,9,659,1
35,1,2008,2358,8,350,1
79,1,2010,2353,8,343,1
80,1,1982,2348,4,366,1
73,2,2344,1984,4,360,1
70,1,1987,2339,7,352,1
90,1,1837,2337,5,500,1
52,1,1750,1438,5,312,0
12,0,2199,1837,4,362,0
123,2,1976,1925,2,51,1
59,2,1687,2043,2,356,0
98,0,1557,1823,4,266,0
33,0,1831,1572,5,259,0
141,2,1767,1831,4,64,0
62,1,1351,1831,2,480,1
32,1,1162,1830,3,668,1
187,0,1829,1874,4,45,0
74,1,1772,1818,4,46,1
170,1,1827,1924,9,97,1
46,1,1805,1815,9,10,1
134,1,1818,2221,13,403,1
63,2,2162,1821,9,341,1
89,2,1811,1728,8,83,1
68,1,1531,1807,6,276,1
156,1,1847,1793,5,54,0
26,2,1781,1791,5,10,0
141,0,1648,1785,9,137,0
60,2,2477,1785,9,692,1
41,2,2105,1785,8,320,1
118,1,1785,2105,5,320,1
119,2,2197,1785,9,412,1
106,2,2477,1785,7,692,1
120,0,1782,1874,11,92,0
95,2,1764,1919,4,155,0
36,1,2015,1764,14,251,0
38,1,1858,1748,9,110,0
63,2,1748,1841,9,93,0
48,1,1090,1747,4,657,1
40,1,2443,1747,9,696,0
76,1,1678,1737,3,59,1
103,2,1732,1460,3,272,1
81,0,1732,1752,6,20,0
20,1,1735,2082,13,347,1
144,1,1742,1918,8,176,1
79,2,2020,1746,6,274,1
38,1,1878,1729,9,149,0
51,2,2061,2007,5,54,1
123,2,1483,1500,5,17,0
44,1,1539,1656,6,117,1
67,1,1301,1535,2,234,1
57,2,1530,1306,5,224,1
54,1,1548,1287,4,261,0
38,2,1268,1566,5,298,0
74,1,1576,1591,4,15,1
37,1,1572,1565,2,7,0
62,1,1578,1505,6,73,0
84,1,1565,1567,6,2,1
51,2,1570,1319,8,251,1
25,2,1925,1573,7,352,1
107,2,1557,1706,4,149,0
70,1,1411,1549,4,138,1
137,2,1539,1492,7,47,1
128,1,1560,1185,3,375,0
26,1,1144,1538,5,394,1
33,2,1931,1541,2,390,1
91,0,1727,1535,5,192,0
60,0,1532,1631,7,99,0
66,1,1546,1465,5,81,0
27,2,1535,1501,9,34,1
33,2,1769,1540,1,229,1
53,2,1348,1557,5,209,0
129,0,1554,1651,6,97,0
32,1,1554,1510,7,44,0
52,1,1645,1540,3,105,0
52,1,1552,1540,7,12,0
79,2,1584,1562,9,22,1
79,2,1556,1391,8,165,1
101,2,1615,1565,5,50,1
33,2,1720,1572,9,148,1
73,2,1842,1577,7,265,1
89,2,1568,1488,7,80,1
43,1,1574,1758,2,184,1
36,1,1168,1572,3,404,1
67,2,1567,1317,7,250,1
74,1,1395,1561,5,166,1
94,1,1575,1474,4,101,0
62,1,1554,1564,8,10,1
78,1,1581,1382,4,199,0
93,2,1851,1585,5,266,1
11,2,1570,1724,7,154,0
48,1,1586,1558,4,28,0
29,2,1547,1517,5,30,1
74,1,1665,1527,5,138,0
39,2,1507,1848,8,341,0
95,2,1723,1512,7,211,1
34,1,1513,2199,11,686,1
32,1,1512,1502,7,10,0
98,1,1508,1683,5,175,1
73,2,1568,1775,3,207,0
78,1,1784,1852,1,68,1
52,1,1797,1740,8,57,0
15,2,1793,1523,6,270,1
37,2,1895,1801,6,94,1
55,2,1859,1810,4,49,1
49,2,1774,1822,5,48,0
37,2,1847,1832,3,15,1
30,1,1841,1902,7,61,1
48,1,1847,2036,4,189,1
47,2,1854,1858,3,4,0
91,2,1851,1716,2,135,1
102,1,1617,1846,7,229,1
94,1,1774,1837,11,63,1
98,1,1853,1658,9,195,0
62,2,1846,1725,4,121,1
92,1,1732,1838,8,106,1
109,2,1831,1705,4,126,1
101,2,1819,1842,5,23,0
66,1,1851,1830,7,21,0
120,2,1823,1686,6,137,1
80,1,1680,1816,3,136,1
55,2,1809,1688,4,121,1
68,1,1823,1676,5,147,0
30,1,1869,1811,11,58,0
86,0,1808,1660,8,148,0
59,2,1711,1821,3,110,0
40,1,1796,1810,8,14,1
40,2,1796,1892,11,96,0
59,2,1789,1661,4,128,1
53,2,1831,1799,6,32,1
71,2,1789,1752,2,37,1
100,1,1771,1778,2,7,1
110,1,1783,1996,13,213,1
44,1,1798,1630,2,168,0
46,1,1637,1792,1,155,1
78,1,1672,1680,5,8,1
47,2,1847,1678,4,169,1
24,1,1063,1678,5,615,1
92,1,1688,1730,3,42,1
77,2,1493,1706,4,213,0
77,2,1700,1497,7,203,1
36,1,1564,1639,6,75,1
42,1,1659,1550,5,109,0
73,2,1612,1550,9,62,1
40,1,1559,1604,2,45,1
62,1,1578,1547,1,31,0
124,2,1645,1555,3,90,1
83,2,1636,1564,5,72,1
133,2,1568,1575,5,7,0
105,2,1583,1586,3,3,0
17,2,1574,1594,4,20,0
128,0,1629,1573,2,56,0
38,1,1550,1562,4,12,1
39,2,1625,1571,6,54,1
73,2,1420,1571,9,151,0
48,1,1565,1773,5,208,1
29,2,1605,1583,3,22,1
43,2,1709,1590,6,119,1
49,2,1621,1600,3,21,1
57,1,1609,1699,4,90,1
68,2,1716,1617,2,99,1
30,1,1677,1603,9,74,0
129,2,1891,1607,7,284,1
50,2,1768,1613,4,155,1
70,1,1620,1760,7,140,1
77,2,1606,1731,6,125,0
53,1,1614,1694,2,80,1
33,2,1831,1614,6,217,1
112,0,1614,1831,8,217,0
62,1,1831,1614,5,217,0
66,1,1614,1831,8,217,1
64,1,1831,1614,4,217,0
80,1,1614,1831,8,217,1
150,1,1614,1587,4,27,0
27,2,1673,1624,3,49,1
83,2,1822,1629,6,193,1
84,2,1728,1637,4,91,1
140,1,1646,1709,6,63,1
33,2,1646,1554,2,92,1
46,1,1554,1646,1,92,1
47,2,1533,1746,3,213,0
57,2,1519,1153,3,366,1
112,1,1527,1706,2,179,1
79,2,1344,1527,3,183,0
17,2,1527,1344,4,183,1
26,1,1344,1527,6,183,1
96,1,1533,1777,11,244,1
88,1,914,1532,5,618,1
138,1,1535,1868,6,333,1
60,1,1825,1502,5,323,0
70,1,1508,1769,10,261,1
64,1,1510,1976,2,466,1
62,1,1527,1438,6,89,0
28,1,1369,1517,3,148,1
98,1,1522,1821,3,299,1
94,1,1505,1832,5,327,1
50,1,1500,1505,3,5,1
82,1,1565,1485,1,80,0
46,1,1000,1951,7,951,1
31,2,1951,1875,3,76,1
52,1,1951,2227,3,276,1
48,1,1621,1951,6,330,1
46,1,1951,1621,4,330,0
21,2,1951,1621,5,330,1
27,2,1334,1443,3,109,0
95,0,1442,1507,5,65,0
136,1,1411,1430,6,19,1
55,2,1487,1441,3,46,1
1,2,1431,1367,1,64,1
36,1,1448,1302,9,146,0
54,1,1444,1435,6,9,0
41,2,1425,1371,2,54,1
97,2,1454,1423,4,31,1
84,1,1412,1411,9,1,0
81,2,1396,1439,4,43,0
91,2,1283,1414,7,131,0
167,2,1400,1412,8,12,0
43,2,1389,1333,7,56,1
42,1,1353,1377,4,24,1
70,1,1391,1366,3,25,0
100,1,1404,1437,6,33,1
40,1,1422,1389,8,33,0
114,1,1139,1383,6,244,1
118,1,1401,1311,4,90,0
25,2,1371,1384,4,13,0
27,2,1500,1379,6,121,1
54,1,1302,1366,4,64,1
87,2,1954,1500,4,454,1
62,1,1500,1621,6,121,1
46,1,1645,1748,3,103,1
51,2,1542,1659,4,117,0
32,1,1746,1645,4,101,0
62,1,1655,1673,3,18,1
120,1,1667,1659,4,8,0
49,2,1654,1693,4,39,0
77,2,1748,1671,9,77,1
35,2,1671,1500,4,171,1
14,1,1671,1500,3,171,0
11,2,1681,1738,3,57,0
91,2,1731,1691,4,40,1
62,1,1707,1678,5,29,0
25,2,1663,1790,4,127,0
47,2,1705,1674,4,31,1
58,1,1717,1460,2,257,0
55,2,1712,1499,4,213,1
38,1,1730,1473,8,257,0
43,2,1704,1731,10,27,0
50,1,1801,1717,6,84,0
57,2,1714,1718,6,4,0
69,2,1803,1723,2,80,1
90,1,1732,1785,4,53,1
173,2,1719,1758,6,39,0
43,2,1748,1730,6,18,1
66,1,1741,1743,4,2,1
103,2,1264,1763,4,499,0
40,1,1232,1761,4,529,1
90,1,1742,1750,8,8,1
107,2,1747,1424,3,323,1
34,2,1735,1763,2,28,0
126,1,1755,1722,4,33,0
108,1,1757,1709,3,48,0
100,1,1720,1748,4,28,1
64,1,1773,1706,5,67,0
66,1,1717,1709,4,8,0
45,2,2247,1718,6,529,1
8,1,1586,2481,6,895,1
46,2,1306,1275,2,31,1
35,2,1259,1319,4,60,0
40,1,1272,1169,2,103,0
8,1,1278,1500,2,222,1
53,2,1265,1500,4,235,0
120,1,1265,1500,4,235,1
73,1,1265,1500,4,235,1
22,0,1264,1268,4,4,0
66,1,1278,1280,4,2,1
85,2,1282,1293,5,11,0
30,1,1500,1279,3,221,0
49,2,1271,1096,7,175,1
70,1,964,1267,3,303,1
19,0,1270,1179,3,91,0
80,1,1277,1490,5,213,1
123,2,1919,1858,2,61,1
48,1,2089,1819,4,270,0
69,2,1794,1791,8,3,1
65,2,1949,1811,3,138,1
97,2,1835,1839,3,4,0
83,2,1803,1874,10,71,0
56,1,1904,1927,6,23,1
81,2,1944,1938,11,6,1
68,2,1922,1688,8,234,1
98,1,1693,1903,4,210,1
45,2,1880,1699,4,181,1
28,1,1853,1828,9,25,0
59,2,1838,1828,9,10,1
91,0,1828,1471,3,357,0
32,1,1828,1796,5,32,0
69,2,1828,1500,2,328,1
70,1,1850,1757,5,93,0
49,2,1942,1757,2,185,1
4,1,1616,1708,4,92,1
37,2,1630,1626,8,4,1
69,1,1415,1571,4,156,1
121,2,1365,1586,8,221,0
19,2,1365,1551,5,186,0
45,2,1796,1365,5,431,1
35,2,1418,1365,2,53,1
59,2,1796,1365,4,431,1
92,1,1405,1365,4,40,0
19,2,1365,1593,4,228,0
40,1,1500,1365,2,135,0
28,1,1205,1365,9,160,1
39,2,1365,1796,5,431,0
43,2,1500,1365,3,135,1
66,1,1500,1365,3,135,0
98,1,1500,1574,8,74,1
33,2,1500,1308,5,192,1
38,1,1500,1796,3,296,1
24,1,1796,1500,2,296,0
168,1,1500,1796,4,296,1
76,0,1381,1407,1,26,0
51,0,1408,1380,5,28,0
47,2,1366,1420,3,54,0
102,1,1242,1413,6,171,1
33,0,1418,1235,5,183,0
36,1,1609,1401,9,208,0
25,0,1207,1406,1,199,0
25,2,1399,1223,2,176,1
9,1,1406,1525,2,119,1
67,2,1397,1319,4,78,1
67,0,1317,1400,7,83,0
61,2,1391,1306,5,85,1
36,1,1314,1382,3,68,1
35,0,1380,1436,9,56,0
83,2,1503,1366,11,137,1
37,2,1794,1368,2,426,1
23,0,1623,1368,5,255,0
89,2,1459,1376,4,83,1
27,0,1373,1461,4,88,0
77,2,1364,1292,5,72,1
47,1,1364,1500,6,136,1
24,1,1374,1387,4,13,1
63,2,1441,1367,3,74,1
44,1,1405,1545,4,140,1
28,1,1424,1519,4,95,1
117,2,1311,1534,6,223,0
105,2,1441,1500,6,59,0
101,2,1978,2139,4,161,0
72,1,1905,2133,6,228,1
69,2,2126,1981,3,145,1
145,2,2159,2136,14,23,1
83,2,1972,2153,3,181,0
85,2,2149,1868,7,281,1
55,1,1904,2143,12,239,1
87,2,2138,1900,7,238,1
89,2,1881,2157,3,276,0
77,2,2153,1868,7,285,1
5,2,2151,1717,4,434,1
65,2,2143,2003,17,140,1
103,2,2137,1944,16,193,1
76,1,1222,1234,5,12,1
65,2,1695,1627,5,68,1
56,1,1568,1688,9,120,1
123,0,1688,1699,3,11,0
23,2,1560,1703,4,143,0
99,1,1714,1671,2,43,0
36,2,1706,1633,6,73,1
32,1,1633,1697,8,64,1
96,1,1586,1690,8,104,1
56,1,1699,1751,4,52,1
38,1,1570,1692,5,122,1
40,2,1680,1725,5,45,0
36,2,1690,1690,3,0,0
138,1,1685,1680,1,5,0
162,1,1715,1668,4,47,0
38,1,1633,1658,3,25,1
53,2,1649,1583,11,66,1
29,2,1612,1662,8,50,0
57,0,1662,1642,6,20,0
50,1,1673,1679,4,6,1
29,2,1668,1684,6,16,0
142,1,1694,1709,5,15,1
58,2,1600,1708,5,108,0
97,2,1699,1621,4,78,1
61,2,1691,1622,6,69,1
133,2,1830,1698,14,132,1
65,2,1601,1710,5,109,0
32,2,1703,1587,4,116,1
58,1,1597,1695,10,98,1
12,1,1716,1637,6,79,0
85,2,1720,1726,4,6,0
53,2,1719,1610,6,109,1
51,2,1710,1645,4,65,1
60,1,1723,1644,5,79,0
52,1,1640,1715,3,75,1
31,2,1648,1728,5,80,0
15,2,1719,1655,6,64,1
35,2,1706,1801,4,95,0
60,1,1675,1687,3,12,1
53,1,1696,1731,9,35,1
88,1,1704,1685,4,19,0
54,1,1699,1594,11,105,0
69,2,1769,1698,6,71,1
92,1,1709,1718,6,9,1
26,1,1720,1693,6,27,0
41,1,1730,1735,9,5,1
77,2,1793,1857,7,64,0
91,2,1871,1804,3,67,1
81,2,1790,1853,8,63,0
59,2,1775,1754,6,21,1
29,2,1741,1792,9,51,0
8,0,1500,1792,4,292,0
37,2,1500,1792,3,292,0
61,2,1858,1792,3,66,1
50,1,1792,1858,8,66,1
55,2,1779,1703,7,76,1
154,0,1703,1765,5,62,0
70,1,1281,1427,9,146,1
44,1,1454,1260,9,194,0
57,2,1440,1347,2,93,1
47,2,1053,1474,3,421,0
36,1,1246,1465,5,219,1
42,1,1362,1449,3,87,1
44,1,1255,1437,7,182,1
157,2,1429,1165,4,264,1
93,2,1429,1500,2,71,0
99,2,1405,1423,2,18,0
47,2,1348,1432,3,84,0
73,2,1417,1260,5,157,1
45,2,1395,1331,6,64,1
107,2,1370,1334,4,36,1
56,1,1152,1355,1,203,1
74,1,1175,1338,4,163,1
29,2,1314,1244,4,70,1
80,1,1271,1279,6,8,1
24,2,1222,1417,8,195,0
70,1,1236,1500,5,264,1
61,2,1187,1231,4,44,0
114,1,1187,1393,4,206,1
44,1,1393,1187,5,206,0
78,1,1195,1260,3,65,1
89,2,1146,1208,3,62,0
74,1,1216,1310,2,94,1
72,1,1159,1207,5,48,1
37,1,1152,1198,1,46,1
19,2,1188,1163,2,25,1
37,2,1177,1172,4,5,1
68,1,1184,1301,4,117,1
88,1,1099,1176,1,77,1
115,0,1182,1176,4,6,0
30,1,1185,1231,4,46,1
45,2,1219,1196,5,23,1
71,0,1195,1220,4,25,0
78,1,1374,1179,3,195,0
24,1,1144,1164,3,20,1
69,2,1150,1253,2,103,0
56,1,1162,1139,2,23,0
99,2,1119,1175,1,56,0
79,2,1302,1183,2,119,1
66,1,1135,1172,1,37,1
53,2,1147,1185,1,38,0
142,1,1190,1410,4,220,1
144,0,1416,1183,5,233,0
56,2,1172,1181,4,9,0
30,2,1162,1121,6,41,1
102,1,1135,1151,4,16,1
70,1,1151,1469,4,318,1
59,2,1368,1156,5,212,1
52,1,1169,1144,5,25,0
46,1,1155,1147,4,8,0
130,1,1113,1145,3,32,1
100,1,1143,1192,2,49,1
67,2,1042,1159,3,117,0
52,1,1142,1900,2,758,1
32,1,2073,1890,9,183,0
33,1,2056,2062,7,6,1
85,2,2055,1924,8,131,1
56,1,1865,2049,8,184,1
55,2,2043,1871,8,172,1
65,2,2168,2050,24,118,1
56,1,2065,1960,2,105,0
24,1,1928,2050,7,122,1
119,2,2038,2065,6,27,0
54,1,2051,1995,2,56,0
35,2,1909,2065,8,156,0
86,1,2075,2138,6,63,1
117,2,2061,2122,5,61,0
108,1,1809,2056,8,247,1
141,2,2046,1984,8,62,1
67,2,1879,2061,7,182,0
28,2,2057,1795,5,262,1
138,2,2042,2058,6,16,0
86,0,1961,2044,11,83,0
62,1,1902,2037,12,135,1
53,2,2022,2162,6,140,0
77,2,2335,2025,5,310,1
55,2,2013,2035,8,22,0
107,0,2016,1943,4,73,0
34,1,1727,2012,5,285,1
16,2,2008,1744,4,264,1
59,2,2109,2016,11,93,1
69,2,2150,2023,4,127,1
49,2,2023,1640,8,383,1
31,2,2023,1640,9,383,1
111,2,2006,2232,10,226,0
112,1,2131,1991,12,140,0
38,1,1650,1988,7,338,1
55,2,1979,1913,7,66,1
77,0,1975,2104,7,129,0
102,1,2097,1960,4,137,0
43,2,1845,1975,4,130,0
50,1,1984,1964,5,20,0
77,2,1954,1899,2,55,1
49,1,1962,2080,13,118,1
96,1,1943,1951,12,8,1
40,1,1966,1939,12,27,0
45,2,1926,1982,6,56,0
83,2,1820,1940,3,120,0
107,0,1941,1893,3,48,0
27,1,1867,1932,9,65,1
50,1,1860,1922,3,62,1
42,1,1937,1805,2,132,0
81,2,1930,1807,2,123,1
68,1,1848,1921,8,73,1
5,1,1815,1688,1,127,0
12,1,1236,1815,1,579,1
93,2,1806,1736,6,70,1
66,1,1679,1799,2,120,1
75,2,1791,1687,7,104,1
53,2,1816,1801,2,15,1
50,1,1758,1791,9,33,1
91,2,1949,1966,3,17,0
112,1,1908,1956,9,48,1
71,2,1726,1713,5,13,1
110,1,1841,1712,3,129,0
54,1,1721,1773,5,52,1
62,1,1737,1582,3,155,0
65,2,1730,1560,6,170,1
39,2,1836,1739,2,97,1
58,1,1639,1730,9,91,1
23,2,1725,1537,5,188,1
73,2,1812,1733,8,79,1
62,1,1757,1877,3,120,1
99,2,1742,1897,4,155,0
28,2,1795,1751,5,44,1
58,1,1771,1739,1,32,0
36,1,1727,2084,3,357,1
100,1,1739,1906,4,167,1
35,1,1787,1726,6,61,0
59,2,1446,1739,2,293,0
43,2,1818,1748,3,70,1
61,2,1737,1740,9,3,0
23,2,1728,1642,8,86,1
46,1,1746,1507,13,239,0
15,2,1903,1752,2,151,1
111,2,1694,1763,2,69,0
92,1,1761,1857,6,96,1
52,1,1770,1853,3,83,1
42,1,1805,1758,2,47,0
72,1,1778,1746,6,32,0
65,2,1735,1725,2,10,1
92,1,1739,1980,13,241,1
149,2,1783,1749,3,34,1
56,1,1859,2417,16,558,1
111,2,1853,1629,4,224,1
86,0,1861,1547,8,314,0
76,2,2081,1691,8,390,1
40,1,1967,2074,13,107,1
117,0,1838,2080,6,242,0
35,2,2072,1964,6,108,1
78,1,2072,1500,9,572,0
61,2,1904,2089,15,185,0
64,1,1857,2084,3,227,1
102,1,1814,2080,6,266,1
27,1,2037,2070,3,33,1
59,2,2064,1897,6,167,1
59,2,1867,2064,6,197,0
104,1,2077,2011,9,66,0
69,0,2085,2077,3,8,0
133,2,2073,1837,2,236,1
36,1,1848,2068,3,220,1
137,0,2070,1975,8,95,0
115,0,1899,2076,2,177,0
49,2,2065,2068,16,3,0
102,1,1976,2056,9,80,1
61,2,2051,1810,7,241,1
84,1,1426,1341,3,85,0
53,2,1466,1532,4,66,0
45,1,997,1500,5,503,1
71,1,1515,1879,1,364,1
139,2,1875,1568,3,307,1
161,2,1859,2004,10,145,0
44,1,1862,2199,4,337,1
29,2,1530,1872,4,342,0
51,2,1870,1430,2,440,1
74,1,1691,1858,12,167,1
48,0,1860,1815,6,45,0
131,2,1855,1615,4,240,1
96,1,2068,1500,4,568,0
134,1,1910,2060,8,150,1
61,2,2058,1616,4,442,1
62,1,1693,2055,8,362,1
58,1,1273,2054,6,781,1
49,2,2038,2141,6,103,0
71,2,2034,1747,6,287,1
73,2,1979,2049,6,70,0
87,0,2044,2027,6,17,0
63,2,2014,2023,8,9,0
38,1,2094,1997,11,97,0
43,2,1996,1403,14,593,1
73,2,1994,1522,2,472,1
151,2,1733,2016,6,283,0
47,2,2014,1585,7,429,1
58,1,1535,2012,3,477,1
53,2,2008,1735,10,273,1
75,2,1646,2031,6,385,0
36,1,1913,2020,2,107,1
32,1,2173,2240,11,67,1
77,2,2228,2228,9,0,0
68,1,2078,2228,5,150,1
140,1,2069,2223,4,154,1
124,0,2229,2004,5,225,0
57,1,2233,2540,9,307,1
67,2,2229,1947,5,282,1
51,1,2052,2222,3,170,1
43,1,2164,2212,6,48,1
137,2,2207,1993,16,214,1
72,1,2222,2029,12,193,0
31,2,2364,2222,4,142,1
76,1,2157,2213,6,56,1
71,2,2206,2046,11,160,1
158,1,2214,2336,11,122,1
43,2,2252,2224,2,28,1
66,1,2136,2215,11,79,1
40,1,2277,2201,2,76,0
38,1,2220,1973,4,247,0
91,2,2215,1998,7,217,1
58,1,2064,2215,11,151,1
13,1,2228,2203,11,25,0
115,2,2228,2203,2,25,1
38,1,2103,2194,6,91,1
59,2,2207,2206,15,1,1
69,2,2621,2206,11,415,1
72,1,1829,1807,14,22,0
83,2,1803,1542,4,261,1
54,1,1751,1793,2,42,1
152,1,1807,1719,5,88,0
40,1,1728,1798,2,70,1
60,1,1812,1714,2,98,0
57,2,1397,1376,4,21,1
98,1,1490,1474,5,16,0
143,2,1354,1405,4,51,0
139,2,1503,1494,5,9,1
41,2,2246,1494,10,752,1
142,1,1504,1578,5,74,1
60,1,1507,1490,8,17,0
83,2,1652,1498,1,154,1
100,1,1507,1649,7,142,1
52,1,1482,1493,4,11,1
29,2,1493,2108,4,615,0
67,2,1946,1772,7,174,1
71,2,2057,1782,13,275,1
60,1,1793,1783,9,10,0
34,1,1793,2227,4,434,1
56,2,1783,1781,4,2,1
39,1,1791,1876,10,85,1
53,2,1877,1799,3,78,1
86,1,1935,1784,8,151,0
23,1,1795,1798,2,3,1
63,2,1794,1806,4,12,0
62,0,1803,1900,4,97,0
44,0,1802,1858,7,56,0
111,0,1802,1781,2,21,0
80,1,1722,1794,8,72,1
50,1,1784,1783,3,1,0
12,1,1795,1753,4,42,0
61,2,1500,1795,7,295,0
40,1,1757,1785,1,28,1
104,1,1389,1307,5,82,0
33,2,1678,1299,10,379,1
64,1,1152,1299,3,147,1
62,1,1303,1634,6,331,1
47,2,1278,1530,6,252,0
30,2,1595,1281,6,314,1
24,2,1267,1344,8,77,0
20,2,1332,1277,8,55,1
66,1,1213,1277,8,64,1
12,1,1277,1047,3,230,0
63,1,1047,1277,3,230,1
82,2,1393,1285,3,108,1
87,2,1279,1090,2,189,1
19,2,1268,1255,4,13,1
59,2,1186,1283,3,97,0
124,1,1283,1267,5,16,0
96,1,1290,1270,1,20,0
53,2,1331,1281,4,50,1
39,2,1304,1292,1,12,1
10,1,1305,1293,3,12,0
51,2,1308,1317,8,9,0
18,1,1296,1305,13,9,1
106,1,968,1305,8,337,1
38,1,1293,1466,5,173,1
59,2,1500,1299,7,201,1
111,2,1288,1232,3,56,1
28,1,1289,2108,9,819,1
101,2,1431,1289,6,142,1
15,2,1806,1289,7,517,1
42,2,1289,1311,5,22,0
118,1,1431,1289,3,142,0
34,1,1289,1484,6,195,1
60,1,1289,1810,5,521,1
66,1,1806,1289,5,517,0
21,2,1289,1500,5,211,0
73,2,1409,1297,8,112,1
159,2,1280,1485,6,205,0
74,2,1280,1211,4,69,1
28,1,1211,1280,3,69,1
112,1,1281,1765,6,484,1
55,2,1825,1232,2,593,1
52,1,1492,1191,3,301,0
72,1,1419,1151,1,268,0
106,1,1346,1112,7,234,0
2,1,1118,1456,2,338,1
2,1,1126,1450,2,324,1
2,1,1154,1147,2,7,0
2,2,1227,1179,1,48,1
2,2,1507,1188,2,319,1
2,1,1196,1547,2,351,1
2,2,1467,1209,2,258,1
2,1,1226,1431,1,205,1
2,2,1362,1252,2,110,1
2,2,1076,1319,2,243,0
2,1,1346,1503,2,157,1
2,1,1369,1581,2,212,1
2,2,1567,1400,2,167,1
2,1,1445,1546,1,101,1
2,2,1538,1516,2,22,1
3,1,1630,1556,1,74,0
2,2,1834,1709,2,125,1
54,1,1778,1779,4,1,1
43,2,1881,1963,5,82,0
23,1,1963,1881,3,82,0
7,2,1963,1881,2,82,1
10,2,1963,1881,2,82,1
2,2,1963,1881,2,82,1
48,2,1881,1963,6,82,0
45,2,1918,1904,6,14,1
55,0,1903,1920,7,17,0
71,2,1881,1800,6,81,1
36,1,1973,1881,15,92,0
18,2,1881,1973,6,92,0
33,1,1973,1881,3,92,0
32,2,1881,1973,7,92,0
31,2,1973,1881,3,92,1
2,1,1973,1881,2,92,0
57,2,1881,1973,5,92,0
37,1,1973,1881,2,92,0
15,2,1881,1973,6,92,0
73,2,1863,1713,5,150,1
53,2,1839,1765,5,74,1
55,2,1810,1749,8,61,1
60,1,1973,1810,17,163,0
14,1,1810,1973,14,163,1
54,1,1973,1810,9,163,0
38,2,1810,1973,12,163,0
57,0,1973,1810,10,163,0
11,2,1973,1810,8,163,1
28,1,1810,1973,5,163,1
39,1,1973,1810,2,163,0
11,2,1973,1810,2,163,1
15,2,1973,1810,4,163,1
27,2,1810,1973,8,163,0
31,2,1973,1810,1,163,1
41,0,1973,1810,8,163,0
35,2,1973,1810,15,163,1
30,1,1973,1810,3,163,0
26,2,1973,1810,3,163,1
23,2,1973,1810,2,163,1
24,1,1828,2035,18,207,1
42,1,1900,1774,5,126,0
24,1,1808,1894,7,86,1
10,2,1973,1840,8,133,1
92,1,1892,1770,2,122,0
75,2,1884,1784,3,100,1
116,1,1900,1702,2,198,0
70,2,1888,1918,4,30,0
69,2,1881,1753,4,128,1
54,2,1874,1742,4,132,1
68,1,1888,1780,5,108,0
58,1,1904,1740,8,164,0
79,2,1894,1862,2,32,1
115,2,1888,1700,6,188,1
158,1,1902,1810,3,92,0
131,2,1892,1861,2,31,1
65,2,1885,1742,1,143,1
77,2,1877,1780,4,97,1
108,0,1882,1722,2,160,0
43,2,1873,1809,5,64,1
87,2,1866,1737,1,129,1
29,2,1859,1744,1,115,1
64,1,1874,1700,4,174,0
79,2,1865,1823,2,42,1
76,1,1881,1703,4,178,0
59,2,1891,1713,3,178,1
80,1,1905,1803,4,102,0
125,2,1897,1793,3,104,1
121,2,1890,1755,5,135,1
76,1,1903,1842,3,61,0
68,1,1917,1795,4,122,0
64,1,1931,1803,2,128,0
67,2,1926,1736,1,190,1
59,2,1918,1823,2,95,1
51,2,1910,1813,4,97,1
45,2,1903,1787,2,116,1
45,2,1895,1798,3,97,1
96,2,1888,1765,4,123,1
72,1,1903,1744,4,159,0
117,2,1897,1730,4,167,1
63,2,1890,1768,4,122,1
36,1,1905,1745,3,160,0
81,2,1895,1899,3,4,0
72,1,1906,1888,2,18,0
104,1,1917,1822,2,95,0
75,2,1908,1862,3,46,1
77,2,1898,1881,2,17,1
128,1,1909,1914,2,5,1
80,1,1922,1821,3,101,0
76,1,1931,1977,4,46,1
73,2,1922,1872,4,50,1
71,2,1914,1829,2,85,1
70,1,1375,1500,6,125,1
33,1,1384,1325,2,59,0
29,1,1384,1265,3,119,0
55,1,1384,1950,2,566,1
91,2,1377,1249,4,128,1
53,2,1375,1389,4,14,0
49,2,1378,1361,5,17,1
48,1,1261,1371,4,110,1
20,1,1380,1429,4,49,1
87,2,1369,1368,6,1,1
11,2,1290,1371,9,81,0
110,0,1372,1326,2,46,0
24,2,1361,1383,1,22,0
23,2,1217,1399,4,182,0
81,2,1387,1447,5,60,0
34,1,1474,1387,2,87,0
103,2,1377,1351,4,26,1
29,1,1389,1339,4,50,0
22,1,1389,1400,4,11,1
38,2,1849,1389,5,460,1
46,1,1395,1378,9,17,0
23,2,1370,1257,6,113,1
31,2,1360,1332,5,28,1
51,2,1311,1360,4,49,0
87,2,1714,1360,6,354,1
31,2,1354,1217,5,137,1
38,1,1245,1346,5,101,1
43,2,1346,1099,6,247,1
105,2,1336,1287,4,49,1
53,0,1698,1254,12,444,0
13,1,1254,2344,8,1090,1
22,2,2454,1254,2,1200,1
2,2,1500,1233,2,267,1
25,1,1233,1664,7,431,1
22,2,1902,1233,3,669,1
57,2,1158,1155,7,3,1
100,0,1158,1158,3,0,0
23,2,1158,1324,8,166,0
31,1,1158,1324,8,166,1
7,2,1324,1158,5,166,1
6,1,1158,1324,5,166,1
26,1,1101,1148,7,47,1
16,1,1159,1165,8,6,1
14,1,1166,1295,8,129,1
78,0,1227,1164,4,63,0
4,2,1500,1168,4,332,1
85,2,1157,1156,4,1,1
7,0,1156,1157,3,1,0
44,1,984,1151,4,167,1
61,2,1141,1127,6,14,1
47,1,1150,1223,7,73,1
27,2,1127,1166,4,39,0
36,2,1177,1137,5,40,1
92,1,1155,1125,4,30,0
24,1,1087,1096,5,9,1
32,2,1054,1100,5,46,0
122,1,1105,1386,3,281,1
24,2,1056,1119,2,63,0
15,2,1463,1122,8,341,1
64,1,1124,1573,5,449,1
23,2,1572,1126,3,446,1
22,1,1135,1209,3,74,1
48,1,1143,1269,2,126,1
46,2,1398,1148,4,250,1
32,1,1158,1196,7,38,1
57,2,1393,1163,8,230,1
46,1,1172,1286,7,114,1
51,2,1068,1188,5,120,0
58,1,1207,981,4,226,0
26,1,1208,1194,6,14,0
50,1,1265,1179,3,86,0
12,1,1189,1245,2,56,1
23,2,1174,1266,8,92,0
62,2,1339,1181,3,158,1
44,1,1191,1265,3,74,1
52,1,1351,1172,4,179,0
40,1,1175,1528,4,353,1
17,2,1539,1178,7,361,1
37,2,1171,1016,3,155,1
25,2,1340,1178,6,162,1
26,1,1180,1586,4,406,1
97,2,1563,1183,7,380,1
65,2,1657,1185,8,472,1
54,2,1162,1610,7,448,0
31,1,1163,1641,2,478,1
72,2,1336,1154,4,182,1
53,2,1136,1307,4,171,0
24,2,1383,1141,2,242,1
116,1,1140,1129,6,11,0
51,1,1147,957,3,190,0
29,2,1137,1050,5,87,1
49,1,1147,1225,6,78,1
84,1,1129,1135,3,6,1
66,2,1443,1139,5,304,1
28,1,1142,1469,3,327,1
45,2,1483,1145,1,338,1
127,2,1281,1153,4,128,1
24,1,1156,1545,8,389,1
68,1,1652,1739,2,87,1
42,1,1761,1723,2,38,0
47,2,2200,1725,8,475,1
56,1,1748,1505,3,243,0
56,1,1677,1736,5,59,1
63,2,1577,1754,5,177,0
65,2,1753,1179,4,574,1
73,2,1726,1711,1,15,1
97,2,1693,1743,2,50,0
21,1,1696,1729,3,33,1
88,0,1732,1652,3,80,0
81,2,1718,1696,3,22,1
62,1,1718,1519,2,199,0
76,1,1742,1533,3,209,0
65,2,1712,1605,3,107,1
52,1,1733,1666,3,67,0
75,2,1731,1735,8,4,0
149,2,1722,1600,3,122,1
96,1,1746,1683,2,63,0
89,2,1794,1765,11,29,1
48,2,1729,1564,1,165,1
46,1,1749,2119,5,370,1
21,2,2119,1991,7,128,1
58,1,1349,2119,8,770,1
38,1,846,2119,2,1273,1
72,1,2147,2113,6,34,0
68,0,2044,2156,14,112,0
132,1,2192,2103,6,89,0
22,2,2178,1955,4,223,1
56,1,1928,2164,7,236,1
85,2,2203,2040,8,163,1
44,1,1833,2193,9,360,1
80,1,1980,2173,11,193,1
43,2,2147,2008,16,139,1
98,1,2104,2098,15,6,0
43,2,2029,2117,7,88,0
57,0,2120,2010,8,110,0
70,1,1706,1983,5,277,1
49,2,1906,1928,7,22,0
107,2,1833,1719,4,114,1
52,1,1728,1662,5,66,0
39,2,1500,1500,10,0,0
53,2,1757,1992,8,235,0
46,1,2022,1865,7,157,0
34,1,1708,2016,6,308,1
60,1,1608,2012,10,404,1
37,2,1806,2048,9,242,0
118,1,1934,2031,2,97,1
182,1,1787,2020,6,233,1
2,1,1728,2012,2,284,1
77,2,2322,2012,6,310,1
65,2,2045,2012,2,33,1
38,1,1851,1996,6,145,1
51,0,1936,2001,6,65,0
60,1,1957,1972,7,15,1
38,1,1858,1948,5,90,1
45,2,2027,1976,6,51,1
27,2,2094,2004,3,90,1
43,0,1949,2004,9,55,0
82,1,2095,1947,5,148,0
110,1,1964,1892,4,72,0
65,2,1955,1942,10,13,1
35,2,2215,1966,8,249,1
75,2,2203,1997,8,206,1
147,0,1986,2001,5,15,0
84,1,2047,1855,3,192,0
62,1,1702,1748,2,46,1
87,1,1625,1500,5,125,0
30,1,1644,1810,4,166,1
127,2,1725,1984,10,259,0
36,1,1143,1984,2,841,1
49,2,1983,1281,3,702,1
28,1,1840,1975,5,135,1
64,2,2091,1985,4,106,1
138,1,1891,1974,4,83,1
111,2,1827,1994,4,167,0
64,1,2003,2121,2,118,1
70,2,2002,1499,4,503,1
51,2,1986,2028,3,42,0
132,1,1769,1980,2,211,1
93,0,2050,1973,8,77,0
91,0,1904,1976,10,72,0
58,1,1659,1971,3,312,1
39,2,1965,1741,3,224,1
57,2,1962,1559,3,403,1
68,1,1839,1952,4,113,1
67,1,1702,1946,3,244,1
146,1,1974,1929,8,45,0
61,2,1919,1798,2,121,1
132,1,1880,1904,11,24,1
52,1,1481,1659,4,178,1
91,2,1650,1488,3,162,1
29,2,1634,1611,10,23,1
22,2,1477,1088,2,389,1
69,2,1550,1105,2,445,1
33,2,1653,1105,4,548,1
110,1,1128,1514,3,386,1
25,2,1347,1213,3,134,1
44,2,1322,1500,2,178,0
51,2,1814,1805,4,9,1
41,2,1904,1887,5,17,1
99,2,1872,2021,5,149,0
164,1,1817,1863,11,46,1
40,1,1873,1887,2,14,1
21,2,1951,1882,8,69,1
45,2,2062,1888,3,174,1
115,2,1875,1975,2,100,0
34,2,2109,1879,9,230,1
20,1,1893,1813,5,80,0
53,2,1902,1904,6,2,0
61,2,1857,1916,28,59,0
79,2,1905,1902,2,3,1
19,2,2161,1910,4,251,1
83,2,1905,1690,5,215,1
91,2,1891,2006,5,115,0
134,1,1900,1880,4,20,0
85,0,1878,1927,2,49,0
53,2,1738,1500,3,238,1
46,1,1488,1738,8,250,1
72,1,1738,1500,3,238,0
63,0,1726,1738,13,12,0
60,1,1500,1738,11,238,1
31,2,1726,1688,5,38,1
62,1,1646,1715,11,69,1
59,2,1500,1715,11,215,0
48,1,1500,1715,4,215,1
76,1,1715,1652,3,63,0
49,2,1715,1115,2,600,1
115,0,1712,1779,2,67,0
58,1,1712,1500,3,212,0
15,2,1712,1087,3,625,1
50,1,1500,1712,10,212,1
57,2,1430,1712,1,282,0
74,1,1650,1699,4,49,1
69,2,1500,1713,5,213,0
68,1,1410,1709,3,299,1
23,2,1709,1500,3,209,1
55,2,1692,1741,3,49,0
57,2,1692,1500,3,192,1
88,1,1361,1688,2,327,1
81,2,1683,1366,3,317,1
25,2,1667,1480,2,187,1
61,2,1663,1500,4,163,1
74,1,1663,1487,2,176,0
68,1,1487,1663,2,176,1
26,1,926,1663,3,737,1
25,1,1852,1663,2,189,0
60,2,1663,1223,4,440,1
48,1,1500,1663,3,163,1
25,2,1653,1535,5,118,1
94,1,1653,1500,6,153,0
58,1,1653,1500,6,153,0
73,2,1653,1403,5,250,1
11,1,1403,1653,3,250,1
22,1,1500,1653,4,153,1
49,2,1645,1436,7,209,1
114,1,1370,1639,5,269,1
46,1,1659,1592,2,67,0
22,1,1211,1659,2,448,1
201,0,1665,1526,6,139,0
65,2,1822,1767,11,55,1
67,2,1754,1835,5,81,0
51,2,1732,1784,4,52,0
135,2,1875,1739,7,136,1
63,2,1731,1653,9,78,1
69,2,1721,1697,7,24,1
121,2,1696,1733,6,37,0
65,2,1722,1727,4,5,0
129,2,1779,1731,5,48,1
85,2,1766,1741,3,25,1
56,1,1751,1745,5,6,0
123,2,1793,1761,4,32,1
49,2,1737,1772,3,35,0
55,2,1762,1747,6,15,1
62,1,1664,1754,3,90,1
95,2,1748,1614,5,134,1
160,1,1651,1740,2,89,1
96,1,1748,1813,6,65,1
85,2,1737,1752,6,15,0
90,1,1802,1725,2,77,0
33,1,1684,1715,7,31,1
107,2,1709,1726,3,17,0
60,1,1731,1958,6,227,1
65,2,1721,1695,5,26,1
59,2,1611,1735,9,124,0
69,2,1724,1735,4,11,0
101,2,1671,1737,3,66,0
85,2,1727,1680,5,47,1
47,1,1705,1718,2,13,1
73,2,1708,1696,2,12,1
59,2,1740,1709,8,31,1
68,1,1719,1737,5,18,1
96,1,1833,1705,4,128,0
123,2,1751,1715,5,36,1
113,2,1698,1925,5,227,0
44,1,1709,1706,5,3,0
155,2,1600,1723,3,123,0
74,1,1739,1712,12,27,0
103,2,1705,1564,6,141,1
128,0,1744,1704,2,40,0
70,1,1715,1685,3,30,0
74,1,1637,1707,2,70,1
79,2,1701,1500,6,201,1
81,2,1643,1714,7,71,0
91,0,1706,1714,7,8,0
121,2,1707,1585,4,122,1
180,0,1705,1783,5,78,0
61,2,1694,1695,3,1,0
82,2,2040,2020,12,20,1
92,1,2017,2008,15,9,0
43,2,1846,2025,6,179,0
25,2,2014,1999,8,15,1
68,1,1879,2007,5,128,1
34,1,2012,2216,13,204,1
41,2,2208,2018,9,190,1
26,1,2024,2200,13,176,1
51,2,2019,1778,3,241,1
118,1,2055,2007,8,48,0
65,2,1997,1956,11,41,1
83,2,1840,2013,8,173,0
45,2,2008,1795,11,213,1
30,1,2018,2053,11,35,1
58,0,1971,2019,15,48,0
31,2,2006,2078,17,72,0
129,2,1999,1863,6,136,1
36,1,1967,1989,10,22,1
41,1,1773,1984,8,211,1
32,2,1979,1778,5,201,1
28,1,1972,2447,16,475,1
64,1,1840,1972,6,132,1
144,0,1792,1977,10,185,0
108,1,1990,1913,7,77,0
34,1,2001,2006,15,5,1
38,1,2019,1989,4,30,0
131,2,1981,1865,11,116,1
58,1,1878,1973,20,95,1
24,1,1987,1883,10,104,0
63,2,1977,1948,7,29,1
45,1,1617,1437,3,180,0
32,1,1471,1610,7,139,1
41,2,1599,1606,5,7,0
37,2,1588,1612,9,24,0
23,2,1520,1601,5,81,0
20,1,1610,1635,6,25,1
84,1,1548,1601,6,53,1
21,2,1527,1614,3,87,0
21,1,1623,1684,4,61,1
79,2,1524,1637,3,113,0
71,2,1626,1624,6,2,1
53,2,1618,1525,4,93,1
72,1,1703,1604,3,99,0
55,2,1494,1619,7,125,0
32,1,1630,1629,8,1,0
61,2,1594,1642,3,48,0
56,1,1460,1636,7,176,1
87,2,1627,1573,8,54,1
55,2,1615,1662,3,47,0
39,2,1636,1625,5,11,1
72,1,1610,1614,3,4,1
25,2,1602,1621,5,19,0
128,0,1624,1602,5,22,0
19,2,1591,1575,7,16,1
57,2,1572,1869,11,297,0
28,1,1561,1557,3,4,0
60,1,1751,1539,10,212,0
69,2,1530,1444,5,86,1
136,2,1922,1533,5,389,1
48,1,1468,1524,6,56,1
30,1,1524,1513,6,11,0
57,2,1511,997,5,514,1
26,0,1511,1528,5,17,0
69,2,1499,1519,11,20,0
71,0,1474,1500,8,26,0
114,1,1500,1492,5,8,0
9,2,1482,1455,6,27,1
54,1,1310,1476,7,166,1
23,2,1466,1433,5,33,1
23,2,1506,1476,7,30,1
21,2,1514,1486,8,28,1
40,1,1495,1562,7,67,1
50,1,1306,1489,7,183,1
57,2,1479,1459,5,20,1
24,1,1490,1487,5,3,0
40,2,1453,1503,5,50,0
16,1,1516,1467,7,49,0
77,2,2131,2103,10,28,1
68,1,2144,2079,12,65,0
78,1,2046,2136,12,90,1
41,2,2136,2243,4,107,0
109,2,2136,1931,8,205,1
30,1,1931,2136,5,205,1
33,2,2136,1931,8,205,1
43,2,1931,2136,7,205,0
72,1,2136,1931,8,205,0
109,2,2123,2214,6,91,0
100,1,2004,2115,8,111,1
61,2,2108,1984,6,124,1
88,1,1935,2102,8,167,1
62,1,2109,2240,6,131,1
122,1,1902,2104,14,202,1
32,1,1980,2097,5,117,1
79,2,2204,2097,3,107,1
104,1,2097,2243,3,146,1
70,0,2085,2097,10,12,0
136,0,2178,2094,13,84,0
144,1,2104,2124,11,20,1
66,1,2119,1959,7,160,0
47,2,1595,1332,2,263,1
58,1,1334,1735,10,401,1
54,1,1334,2475,4,1141,1
38,1,2108,1334,7,774,0
71,2,1738,1337,9,401,1
57,2,2549,1337,5,1212,1
53,2,1337,1331,11,6,1
43,2,1337,1331,6,6,1
67,2,1337,1331,8,6,1
147,2,1601,1341,9,260,1
38,1,1347,1546,5,199,1
76,1,1330,1653,5,323,1
86,1,1776,1735,7,41,0
99,2,1721,1834,10,113,0
47,2,1793,1730,7,63,1
44,1,1784,1812,8,28,1
62,1,1812,2012,2,200,1
44,1,1624,1812,9,188,1
85,0,1812,1897,5,85,0
91,2,1791,1812,10,21,0
71,2,1812,1704,4,108,1
63,2,1812,1812,3,0,0
53,1,1816,1812,9,4,0
76,1,1812,1853,5,41,1
124,1,1156,1812,1,656,1
132,1,1757,1812,5,55,1
70,1,1812,1852,3,40,1
70,1,1285,1812,5,527,1
39,2,1812,1820,5,8,0
61,2,1812,1500,3,312,1
62,1,1711,1812,1,101,1
38,1,1625,1812,6,187,1
95,2,1711,1812,2,101,0
69,2,1812,1792,4,20,1
35,2,1812,1624,2,188,1
43,2,1742,1812,2,70,0
109,2,1760,1812,11,52,0
79,2,1812,1726,3,86,1
74,1,1800,1812,7,12,1
120,1,1812,1834,2,22,1
62,1,1812,2203,5,391,1
189,0,1500,1812,4,312,0
86,0,1921,1812,8,109,0
88,1,1812,1921,5,109,1
35,2,1812,1664,2,148,1
39,2,1755,1812,6,57,0
72,1,1500,1812,1,312,1
31,2,1812,1709,2,103,1
72,1,1812,1837,5,25,1
95,2,1695,1812,10,117,0
94,1,1812,1975,5,163,1
48,1,1446,1812,5,366,1
126,1,1862,1812,6,50,0
51,2,1812,1735,1,77,1
83,2,1787,1812,4,25,0
65,1,983,1714,4,731,1
60,1,994,1192,6,198,1
57,2,1511,997,5,514,1
39,2,1616,998,5,618,1
62,1,999,1701,2,702,1
26,1,999,1368,9,369,1
93,2,1810,999,2,811,1
48,1,999,1810,6,811,1
43,2,1810,999,8,811,1
34,1,999,1810,2,811,1
35,2,1810,999,2,811,1
46,1,999,1810,2,811,1
45,2,1300,1006,7,294,1
28,2,1812,1006,5,806,1
26,2,1424,1006,7,418,1
27,1,1006,1293,2,287,1
76,1,1015,981,2,34,0
61,2,1349,981,4,368,1
29,2,1601,981,7,620,1
28,1,1024,952,5,72,0
73,1,965,1160,4,195,1
105,2,1366,970,3,396,1
49,2,1164,984,2,180,1
16,1,1003,1122,4,119,1
65,0,1003,1813,2,810,0
52,1,1003,1623,4,620,1
82,1,2207,2079,6,128,0
92,1,2017,2070,6,53,1
42,1,2088,1815,9,273,0
86,1,1890,2083,11,193,1
86,2,2078,1843,4,235,1
102,0,2077,2090,4,13,0
42,1,1842,2073,6,231,1
54,2,2064,1986,6,78,1
77,1,1818,2060,10,242,1
62,2,2052,1940,2,112,1
36,1,1949,2044,9,95,1
118,1,2060,1865,5,195,0
122,1,2035,2050,8,15,1
75,2,2043,1898,4,145,1
90,1,2050,2028,9,22,0
57,2,2044,1874,6,170,1
69,2,1877,2044,10,167,0
101,2,2044,1491,4,553,1
62,1,2044,2122,6,78,1
66,0,2044,2022,5,22,0
107,2,2037,1882,5,155,1
25,2,1866,2054,13,188,0
83,2,2041,2081,4,40,0
117,2,1979,2055,9,76,0
129,2,2047,1961,17,86,1
46,1,2041,2035,19,6,0
46,1,2035,1910,2,125,0
90,1,2043,2023,19,20,0
45,2,2016,1880,10,136,1
31,2,1967,2028,8,61,0
47,2,1599,1647,4,48,0
9,0,1599,1647,3,48,0
65,2,1612,1610,5,2,1
154,1,1382,1605,8,223,1
53,2,1592,1671,5,79,0
19,2,1586,1416,4,170,1
47,2,1572,1597,2,25,0
42,1,1667,1584,8,83,0
52,1,1500,1833,4,333,1
108,1,1665,1826,5,161,1
64,1,1619,1820,3,201,1
31,2,1814,1500,2,314,1
64,1,1626,2082,4,456,1
48,1,1639,1728,7,89,1
33,2,1733,1661,6,72,1
69,2,1986,1666,5,320,1
63,2,1681,1488,3,193,1
47,2,1521,1709,4,188,0
95,2,1686,1745,2,59,0
15,2,1809,1701,7,108,1
68,1,1713,1882,7,169,1
14,1,1773,1685,7,88,0
56,1,1706,1741,6,35,1
30,2,2076,1712,4,364,1
19,1,1735,1771,4,36,1
45,2,1053,840,3,213,1
5,2,1010,840,5,170,1
21,2,1381,840,4,541,1
129,2,966,857,3,109,1
30,1,860,1424,3,564,1
85,1,1314,860,3,454,0
51,2,1871,2101,8,230,0
44,2,2250,1793,2,457,1
58,1,1820,1543,2,277,0
124,1,1826,2019,2,193,1
70,1,1531,1822,1,291,1
140,1,1826,2162,2,336,1
50,1,1626,1820,8,194,1
120,1,1812,1834,2,22,1
122,2,1716,1850,4,134,0
42,1,1879,1837,6,42,0
79,2,1825,1850,3,25,0
70,1,1832,1983,2,151,1
80,1,1844,1783,3,61,0
81,2,1837,1687,2,150,1
111,2,1861,1837,7,24,1
56,1,1808,1826,2,18,1
42,2,1821,1600,3,221,1
79,2,1818,1558,3,260,1
52,1,1540,1814,6,274,1
115,2,1797,1962,1,165,0
59,2,1879,1806,2,73,1
96,1,1931,1790,4,141,0
62,1,1800,1853,3,53,1
54,1,1802,2181,2,379,1
59,2,1744,1817,7,73,0
126,1,1828,1834,3,6,1
44,1,1293,1827,1,534,1
85,2,1823,1560,3,263,1
85,2,1861,1833,3,28,1
46,1,1802,1822,2,20,1
47,2,1822,1324,2,498,1
70,2,2114,1826,11,288,1
81,2,1771,1840,2,69,0
48,1,1877,1827,2,50,0
76,1,1827,1812,2,15,0
56,1,1803,1809,3,6,1
75,2,1802,1652,4,150,1
48,1,1804,2222,2,418,1
52,1,1810,1990,3,180,1
57,2,1795,1880,2,85,0
88,1,1804,1783,3,21,0
69,2,2020,1788,2,232,1
58,0,1510,1796,7,286,0
58,2,1618,1572,5,46,1
53,2,1572,1720,2,148,0
78,1,1589,1553,3,36,0
76,1,1521,1580,3,59,1
21,2,1710,1587,2,123,1
114,1,1587,1562,2,25,0
107,0,1586,1637,2,51,0
54,0,1638,1584,3,54,0
95,2,1575,1527,2,48,1
28,1,1533,1565,11,32,1
28,2,1627,1574,7,53,1
91,2,1462,1589,2,127,0
47,2,1572,1600,5,28,0
88,1,1612,1579,4,33,0
52,1,1620,1723,5,103,1
73,2,1351,1637,9,286,0
68,1,1671,1626,8,45,0
92,1,1626,1615,3,11,0
33,2,1614,1649,7,35,0
20,1,1610,1603,2,7,0
41,2,1596,1463,3,133,1
93,2,1591,1607,4,16,0
50,1,1618,1629,4,11,1
155,2,1641,1628,4,13,1
74,1,1636,1725,4,89,1
155,2,1636,1357,4,279,1
127,2,1725,1644,3,81,1
65,2,1500,1500,8,0,0
42,1,1500,1500,5,0,0
60,1,1316,1500,5,184,1
44,1,1306,1500,6,194,1
145,0,1500,1500,6,0,0
68,2,1095,1500,9,405,0
14,1,1500,1386,5,114,0
68,1,1500,1500,6,0,0
58,1,1500,1500,3,0,0
25,2,1500,1500,3,0,0
57,2,1500,1500,8,0,0
24,1,1244,1500,3,256,1
41,2,1500,1334,6,166,1
37,0,1500,1595,4,95,0
45,2,1500,1500,3,0,0
54,1,1306,1500,6,194,1
62,1,1017,1500,3,483,1
57,2,1316,1500,5,184,0
60,0,1500,1230,6,270,0
95,2,1039,1500,2,461,0
66,1,1500,1500,9,0,0
171,2,1500,1500,3,0,0
3,2,1500,1229,3,271,1
126,1,1500,1500,6,0,0
13,1,1500,1500,7,0,0
49,1,1500,1500,4,0,0
59,1,1294,1500,7,206,1
53,2,1491,1500,7,9,0
66,1,1500,1500,5,0,0
59,2,1500,1178,3,322,1
98,1,1500,1500,7,0,0
64,1,1249,1500,4,251,1
43,2,1500,1095,3,405,1
29,2,1500,1449,3,51,1
30,1,1500,1500,9,0,0
54,0,1500,1040,5,460,0
56,1,1500,1500,7,0,0
47,2,1500,1500,3,0,0
46,1,929,1500,1,571,1
59,2,1500,1443,7,57,1
47,2,1567,1500,1,67,1
35,2,1500,1500,6,0,0
11,2,1500,1358,6,142,1
98,1,1500,1500,10,0,0
31,0,1500,1144,6,356,0
39,2,1612,1552,5,60,1
70,1,1562,1602,4,40,1
52,1,1615,1548,3,67,0
66,2,1605,1558,5,47,1
92,1,1571,1536,6,35,0
59,2,2087,1572,6,515,1
43,2,1564,1476,7,88,1
110,1,1573,1633,6,60,1
51,2,2141,1574,4,567,1
117,2,1718,1581,5,137,1
113,1,1589,1694,7,105,1
29,2,1572,1782,7,210,0
48,1,1377,1550,3,173,1
130,1,1553,1882,6,329,1
47,2,1539,1621,5,82,0
55,2,1789,1544,3,245,1
146,1,1557,1496,8,61,0
17,2,1697,1564,5,133,1
57,2,1554,1517,6,37,1
66,1,1559,1789,4,230,1
30,1,1462,1550,3,88,1
38,1,1561,1562,5,1,1
30,2,1567,1573,2,6,0
48,1,1586,1558,4,28,0
60,1,1439,1578,6,139,1
51,2,1577,1127,4,450,1
14,1,1508,1567,2,59,1
156,1,1568,2067,7,499,1
54,1,1099,1567,4,468,1
86,1,1579,1543,8,36,0
59,2,1569,1542,6,27,1
64,1,1388,1563,3,175,1
71,2,1715,1569,6,146,1
105,2,1561,1491,2,70,1
72,1,1569,1653,7,84,1
46,1,1562,1558,4,4,0
42,1,1456,1549,5,93,1
52,1,1559,1623,6,64,1
40,1,1563,1824,11,261,1
48,1,1480,1554,5,74,1
55,2,1842,1558,4,284,1
56,1,1570,1534,7,36,0
60,2,1563,1582,7,19,0
42,1,1652,1568,3,84,0
69,2,1555,1591,4,36,0
50,1,1558,1962,5,404,1
53,2,1651,1566,4,85,1
53,2,1653,1627,3,26,1
116,1,1729,1639,3,90,0
105,2,1630,1651,4,21,0
64,1,1653,2040,3,387,1
45,2,1645,1559,6,86,1
53,2,1860,1650,4,210,1
101,2,1583,1663,4,80,0
51,2,1651,1709,14,58,0
54,1,880,1651,3,771,1
159,2,1619,1662,5,43,0
104,1,1669,1810,4,141,1
77,2,1588,1682,4,94,0
95,2,1670,1727,6,57,0
68,1,1606,1651,2,45,1
45,2,1639,1680,3,41,0
107,2,1626,1705,6,79,0
46,1,1641,1500,8,141,0
81,2,1622,1652,11,30,0
107,0,1653,1643,5,10,0
41,2,1611,1665,3,54,0
39,2,1653,1706,6,53,0
119,2,1644,1589,9,55,1
84,1,1652,1731,8,79,1
47,2,1662,1663,3,1,0
113,0,1667,1663,14,4,0
87,2,1655,1553,13,102,1
61,2,1653,1222,8,431,1
171,2,1547,1667,8,120,0
53,2,1659,1561,4,98,1
71,2,1728,1668,6,60,1
107,2,1804,1675,11,129,1
32,1,1621,1666,3,45,1
61,2,1659,1547,10,112,1
46,1,1543,1651,11,108,1
142,1,1665,1547,13,118,0
18,1,1555,1658,3,103,1
56,2,1646,1684,8,38,0
89,2,1711,1655,11,56,1
74,1,1606,1645,3,39,1
66,1,1656,1661,14,5,1
47,2,1558,1670,6,112,0
67,2,1660,1614,7,46,1
54,1,1664,1649,3,15,0
101,2,1638,1679,5,41,0
99,2,1629,1566,5,63,1
51,2,1623,1428,5,195,1
128,1,1565,1614,3,49,1
114,1,2115,1910,2,205,0
105,2,1891,2106,3,215,0
54,1,1902,1878,2,24,0
104,1,1882,2193,4,311,1
47,2,2006,1890,2,116,1
100,1,2047,1872,4,175,0
49,2,1860,1851,1,9,1
121,2,1916,1871,2,45,1
102,0,1868,1949,1,81,0
36,1,1584,1864,3,280,1
73,2,1928,1875,5,53,1
12,1,1882,2046,2,164,1
45,2,1870,1837,4,33,1
71,0,1958,1867,2,91,0
88,0,1865,1914,5,49,0
112,1,1879,1850,8,29,0
65,2,1834,1875,1,41,0
91,2,2100,1840,11,260,1
119,2,1817,2050,1,233,0
102,1,1978,2062,11,84,1
71,2,2057,1782,13,275,1
44,1,1770,2053,8,283,1
77,2,2048,1801,13,247,1
131,2,1883,2067,6,184,0
8,2,1866,2088,6,222,0
102,1,1999,2077,6,78,1
65,2,2070,1910,5,160,1
48,1,1816,2064,8,248,1
57,2,2058,1833,7,225,1
45,2,2050,1894,5,156,1
142,1,2076,2035,6,41,0
78,1,2056,1873,3,183,0
26,1,1996,2043,5,47,1
119,0,2049,1895,5,154,0
118,1,1798,2044,2,246,1
58,1,2001,2030,4,29,1
60,1,1980,2017,2,37,1
63,2,2010,1781,5,229,1
87,2,1998,1920,8,78,1
50,1,1684,1993,5,309,1
29,2,1989,1653,15,336,1
46,1,1838,1979,10,141,1
41,2,1972,1718,6,254,1
103,0,2283,2358,4,75,0
109,0,2214,2286,2,72,0
92,1,2232,2272,8,40,1
77,2,2264,2082,15,182,1
76,1,1826,2262,5,436,1
22,2,2255,2008,6,247,1
62,1,2007,2249,14,242,1
70,1,1801,2246,8,445,1
63,0,2239,2401,5,162,0
58,1,1471,2239,12,768,1
95,1,2094,2228,6,134,1
109,0,2229,2220,17,9,0
42,1,2162,2214,8,52,1
102,1,2236,2148,2,88,0
97,2,2268,2254,17,14,1
35,2,1787,1862,14,75,0
44,1,1722,1855,3,133,1
45,2,1871,1866,11,5,1
56,1,1876,1913,12,37,1
37,2,2049,1882,14,167,1
107,1,1893,1902,2,9,1
118,1,1713,1887,3,174,1
37,2,1882,1683,3,199,1
80,1,1822,1872,4,50,1
47,2,1842,1885,5,43,0
115,2,1878,1720,2,158,1
37,1,1890,1866,2,24,0
82,1,1876,1879,5,3,1
50,1,1267,1616,4,349,1
53,2,1253,1267,5,14,0
36,1,1267,1253,2,14,0
100,0,1258,1620,6,362,0
59,2,1427,1265,5,162,1
43,2,1247,1436,3,189,0
32,1,1156,1238,2,82,1
36,1,1247,1359,4,112,1
57,2,1550,1250,10,300,1
87,1,1261,1461,6,200,1
58,1,1263,1770,3,507,1
53,2,1759,1265,8,494,1
11,2,1252,1290,4,38,0
37,2,1523,1256,5,267,1
70,2,1246,1201,3,45,1
36,1,1250,1235,4,15,0
73,2,1222,1262,2,40,0
25,2,1252,1233,5,19,1
43,2,1328,1252,5,76,1
9,2,1243,1142,2,101,1
58,1,1237,1231,3,6,0
37,2,1219,1250,4,31,0
24,2,1691,1220,2,471,1
82,1,1233,1196,2,37,0
35,2,1219,1286,3,67,0
109,2,1360,1227,4,133,1
78,1,1235,1339,3,104,1
